#说明:
#	n---short
#	N---Long
#	P---double
#	A---str
#	S---str
#	Q---str(8)	日期
#	O---str
LJZQJE	R	REFFLD(JIOYJE)	累计支取金额		
ZHHUSX	A	1	帐户属性		
ZHHUYE	P	15	2	帐户余额	
ZHHUXZ	A	4	帐户性质		
JZHBBZ	A	1	记帐货币标记		
CDUIRQ	R	REFFLD(RIQIII)	承兑日期		
JIGOLX	A	1	机构类型		
WQZHZT	A	1	网银签约帐户状态		
FUUXII	R	REFFLD(JIOYJE)	复息		
WANCGY	A	8	完成柜员号		
LEIJLX	R	REFFLD(JIOYJE)	累计利息		
FFLJLX	R	REFFLD(JIOYJE)	反方累计利息		
QIANXI	R	REFFLD(JIOYJE)	欠息		
WFZZBZ	A	1	网银服务需要指定转入帐号标志		
ZHUZWM	R	REFFLD(KEHZWM)	帐户中文名		
ZHANGH	A	20	帐号		
BENBYE	R	REFFLD(ZHHUYE)	本币余额		
KJFHBZ	A	1	会计复核标志		
ZHAOLY	R	REFFLD(ZHANGH)	帐号来源		
WCJGDH	A	4	完成机构代号		
ZHAOXH	A	6	帐号序号		
SQWCSJ	N	预授权完成时间		
ZCUNFS	A	1	转存方式		
CHFUCS	P	1	重复次数		
ZHKJJG	R	REFFLD(ZHNGJG)	帐户会计机构		
XDCKJS	R	REFFLD(JISHUU)	协定存款积数		
TIOQBZ	A	1	调期标志		
XCKZED	R	REFFLD(JIOYJE)	协定存款控制额度		
DIZHII	O	62	地址		
TIOZTS	N	调整天数		
LJIABZ	A	1	累加标志		
TIOQFS	A	1	调期方式		
TQIXDH	A	8	调期协定号		
XIEDLL	R	REFFLD(LILVLL)	协定利率		
TIOZLX	A	1	调整类型		
XIEYMJ	R	REFFLD(JIOYJE)	协议买价		
DLRZJH	R	REFFLD(ZHJHAO)	代理人证件号码		
DLRZZL	R	REFFLD(ZHJNZL)	代理人证件种类		
XYIDRQ	R	REFFLD(RIQIII)	协议到期日		
DAILRM	R	REFFLD(LNXIRM)	代理人		
DAILHM	A	62	代理行行名		
SXE1BH	R	REFFLD(JIEJUH)	授信额度编号		
SHXXYH	A	10	授信协议号		
XIEYBH	A	8	协议编号		
XIEYQX	R	REFFLD(CUNQII)	协议期限		
XEYIMJ	R	REFFLD(JIOYJE)	协议卖价		
SXINZL	A	1	授信种类		
JSLXRQ	R	REFFLD(RIQIII)	计收利息日期		
WLZQLX	R	REFFLD(JIOYJE)	已到期未领取的债券利息		
BIEMNG	A	8	别名		
SJJYJE	R	REFFLD(JIOYJE)	实际交易金额		
ZHA1ZH	R	REFFLD(ZHANGH)	帐号		
FJIASJ	A	6	附加数据		
JISHUU	P	20	2	积数	
SHOQXE	R	REFFLD(JIOYJE)	授权限额		
JOYIJE	R	REFFLD(JIOYJE)	交易金额		
FSHEXZ	A	1	发生额性质		
ZHU1YE	R	REFFLD(ZHHUYE)	帐户余额		
JISHU1	R	REFFLD(JISHUU)	积数		
FANFJS	R	REFFLD(JISHUU)	反方积数		
JIEDBZ	A	1	借贷标记		
HZDXJE	O	42	汉字大写金额		
KAHAO1	A	16	卡号		
JINEGS	A	20	金额公式		
JIOYJE	P	13	2	交易金额	
JOY1RQ	R	REFFLD(RIQIII)	交易日期		
ZHRUZH	R	REFFLD(ZHANGH)	转入帐号		
JIOYLS	R	REFFLD(GUIYLS)	交易流水号		
ZYJCBZ	A	1	中间业务即时处理标志		
QZSQYJ	A	1	企业证书申请依据		
SQNGRQ	R	REFFLD(RIQIII)	申请日期		
QSYJNR	A	62	企业证书申请依据内容		
SHIJCQ	R	REFFLD(CUNQII)	实际存期		
DRHKZH	R	REFFLD(ZHANGH)	第二还款帐号		
DIZJJE	R	REFFLD(JIOYJE)	递增(减)额		
YDRZRQ	R	REFFLD(RIQIII)	约定入帐日期		
LJHQLX	R	REFFLD(JIOYJE)	累计活期利息		
YDRZCC	P	1	约定入帐场次		
HUOQLL	R	REFFLD(LILVLL)	活期利率		
ZZGDJE	R	REFFLD(JIOYJE)	自动转帐固定金额		
SHLIRQ	R	REFFLD(RIQIII)	受理日期		
WFXEBZ	A	1	网银服务需要指定限额标志		
DLIYWH	A	15	代理业务号		
ZZTXLL	R	REFFLD(LILVLL)	再转贴现利率		
ZHHUZT	R	REFFLD(JILUZT)	帐户状态		
ZDZZZQ	A	1	自动转帐周期		
ZDZCZH	R	REFFLD(ZHANGH)	自动转存帐户		
SQXJXE	R	REFFLD(JIOYJE)	授权现金限额		
XCUNBZ	A	1	续存标记		
SQGYLS	R	REFFLD(GUIYLS)	预授权完成柜员流水号		
SHOQFS	A	1	授权方式		
ZDRZBS	R	REFFLD(DRTHBS)	自动入帐笔数		
SHOUQM	A	14	授权码		
XCUNCS	R	REFFLD(ZHQUCS)	续存次数		
SHOQMM	R	REFFLD(JIOYMM)	授权密码		
SHOQJB	A	1	授权级别		
ZDRZJE	R	REFFLD(JIOYJE)	自动入帐金额		
YSHOQH	A	6	预授权号		
YSHQZT	A	1	预授权状态		
YSHQZL	A	1	授权种类		
SHOQGY	R	REFFLD(GUIYDH)	授权柜员		
PNGJYE	R	REFFLD(ZHHUYE)	平均余额		
PJCDYH	R	REFFLD(KEHZWM)	票据承兑银行		
PJCDRQ	R	REFFLD(RIQIII)	票据承兑日期		
JBZHBZ	A	1	基本帐户标记		
ZHU2YE	R	REFFLD(ZHHUYE)	帐户余额		
FABOHH	R	REFFLD(LIANHH)	发报行号		
PJCDBH	R	REFFLD(JIEJUH)	票据承兑编号		
XUHAOO	P	7	序号		
CUNZHH	A	8	存折号码		
MRWBPH	A	8	买入外币票据编号		
PJSKZH	R	REFFLD(ZHANGH)	票据收款人帐号		
PJSKHM	R	REFFLD(KEHZWM)	票据收款行名称		
GBCGBZ	A	1	广播成功标志		
PJSKRM	R	REFFLD(KEHZWM)	票据收款人名称		
ZDJHCC	R	REFFLD(YDRZCC)	最大交换场次		
DAIZZH	R	REFFLD(ZHANGH)	呆帐帐号		
CHUSRQ	R	REFFLD(RIQIII)	出生日期		
DBKYWH	R	REFFLD(YEWUDH)	呆帐本金科目业务代号		
ZQUANM	R	REFFLD(KEHZWM)	债券名称		
WEIYLL	R	REFFLD(LILVLL)	违约利率		
ZHYOLX	A	6	摘要类型		
FXQSRQ	R	REFFLD(RIQIII)	发行起始日期		
YDJJZH	R	REFFLD(ZHANGH)	银团贷款基金帐号		
QISHLS	R	REFFLD(GUIYLS)	起始流水号		
PIAOJH	A	15	票据号码		
YINHDM	A	2	银行代码		
BEIYZF	A	20	备用字符		
DJIBBZ	A	2	登记簿标志		
DJIBMC	A	5	登记簿名称		
YUEEXZ	A	1	余额性质		
YUEEFX	A	1	余额方向		
PIOJZL	A	1	票据种类		
XIOZHM	R	REFFLD(HNGMNG)	小站行名		
PIOJZS	N	10	票据张数		
XIOZHH	R	REFFLD(LIANHH)	小站行号		
PJMXZL	A	1	票据明细种类		
WEIXBZ	A	1	尾箱标志		
PJFKZH	R	REFFLD(ZHANGH)	票据付款人帐号		
PJFKHM	R	REFFLD(KEHZWM)	票据付款行名称		
RZZHBZ	A	1	入总帐标志		
ZNGZLX	A	1	总帐类型		
PJFKRM	R	REFFLD(KEHZWM)	票据付款人名称		
WEITRQ	R	REFFLD(RIQIII)	委托日期		
YWU1LX	A	1	业务类型		
FHHCLB	A	1	分行汇差类别		
HNGMNG	O	62	行名		
LIANHH	A	11	联行行号		
DAILZT	A	1	代理状态		
LHNGLB	A	1	联行类别		
YEWUXZ	A	2	业务性质		
YWU2LX	A	1	业务类型		
PLCLWJ	A	32	批量处理文件名		
WEIXYE	R	REFFLD(ZHHUYE)	尾箱余额		
MAIRZH	R	REFFLD(ZHANGH)	买入帐号		
MAIRJE	R	REFFLD(JIOYJE)	买入金额		
QNRIYE	R	REFFLD(ZHHUYE)	前日余额		
MAIRBZ	A	2	买入币种		
MAIRRQ	R	REFFLD(RIQIII)	买入日期		
BEIYRQ	R	REFFLD(RIQIII)	备用日期		
MAIRHM	A	62	买入户名		
MAIRUJ	R	REFFLD(PAIJIA)	买入价		
BQQXJS	R	REFFLD(JISHUU)	本期取现积数		
SHIFXZ	A	1	是否销折		
WEIXDH	A	4	尾箱号		
XJSHOU	R	REFFLD(JIOYJE)	现金收		
HXIORQ	R	REFFLD(RIQIII)	核销日期		
WQZRZH	R	REFFLD(ZHANGH)	网银签约转入客户帐号		
ZBKYWH	R	REFFLD(YEWUDH)	正常本金科目业务代号		
WQZHLX	A	1	网银签约客户帐号类型		
DANBFS	A	1	担保方式		
DBDWMC	R	REFFLD(KEHZWM)	担保单位名称		
DBDWBH	R	REFFLD(KEHHAO)	担保单位编号(客户号)		
BENJIN	R	REFFLD(JIOYJE)	本金		
KAHAOO	A	16	卡号		
CHOJIA	R	REFFLD(PAIJIA)	钞价		
QXJXFF	A	1	取现计息方法		
HXIOZT	A	1	核销状态		
XNZHBZ	A	1	现转标志		
KHZHLX	A	1	客户帐号类型		
RMZHLX	R	REFFLD(KHZHLX)	人民币客户帐号类型		
HXIOGY	R	REFFLD(GUIYDH)	核销柜员		
DFQSRQ	R	REFFLD(RIQIII)	兑付起始日期		
ZJYZBZ	A	1	证件验证标志		
DFHHAO	R	REFFLD(LIANHH)	兑付行行号		
CHMRUJ	P	12	6	钞买价	
XJDFSE	P	15	2	现金贷发生额		
QSZXDH	A	4	清算中心代号		
XJDFBS	R	REFFLD(BISHUU)	现金贷方笔数		
QXIORQ	R	REFFLD(RIQIII)	取消日期		
JHQXTS	R	REFFLD(TIANSH)	计活期息天数		
HNKACS	P	1	换卡次数		
PNGZHH	A	13	凭证号		
XNJNFU	R	REFFLD(JIOYJE)	现金付		
DBRKHH	R	REFFLD(KEHHAO)	担保人客户号		
PNGZXH	A	8	凭证序号		
BENPZT	A	1	本票状态		
QXIOGY	R	REFFLD(GUIYDH)	取消柜员		
QXGYLS	R	REFFLD(GUIYLS)	取消柜员流水号		
XJJFSE	P	15	2	现金借发生额		
XJJFBS	R	REFFLD(BISHUU)	现金借方笔数		
KAMIMA	R	REFFLD(JIOYMM)	卡密码		
KAM1MA	R	REFFLD(JIOYMM)	卡密码		
PNGZPH	A	1	凭证批号		
PNGZRQ	R	REFFLD(RIQIII)	凭证日期		
PNGZMC	A	20	凭证名称		
TSHPZH	A	20	特殊凭证号		
PNGZFH	R	REFFLD(YNGYJG)	凭证分行		
PNGZZL	A	2	凭证种类		
XJDRJE	R	REFFLD(JIOYJE)	现金调入金额		
XJDRBS	R	REFFLD(BISHUU)	现金调入笔数		
JDBZZW	A	40	借贷标志中文		
ZNGWSM	O	22	中文说明		
FUHEBZ	A	1	复核标志		
ZNGWMC	A	42	中文名称		
JIOHCC	R	REFFLD(YDRZCC)	交换场次		
XJXMDM	A	10	现金项目代码		
AJJXBJ	R	REFFLD(ZHHUYE)	计息本金(按揭)		
FAKAQD	A	2	发卡渠道		
JXDQQS	R	REFFLD(BENQQS)	计息当期期数(按揭)		
JXZQSH	R	REFFLD(ZONGQS)	计息总期数(按揭)		
JIANCW	A	1	检查位		
ZZPZXH	R	REFFLD(PNGZXH)	终止凭证序号		
JYJEJC	A	6	交易金额检查字段名		
SHFOBZ	A	1	是否标志		
QSPZXH	R	REFFLD(PNGZXH)	起始凭证序号		
FUHEGY	R	REFFLD(GUIYDH)	复核柜员		
JIESZH	R	REFFLD(ZHANGH)	结算帐号		
BQJCJE	R	REFFLD(JIOYJE)	本期结付存款金额		
JSZHYE	R	REFFLD(ZHHUYE)	结算帐户余额		
XIOHRQ	R	REFFLD(RIQIII)	销户日期		
LIESHU	N	列数		
BQJFLX	R	REFFLD(JIOYJE)	本期结付利息额		
XIOHJG	R	REFFLD(YNGYJG)	销户机构		
XIOHSH	R	REFFLD(KAIHSH)	销户数		
WTJGDH	R	REFFLD(YNGYJG)	委托机构代号		
JIBIEE	A	1	级别		
XHGYLS	R	REFFLD(GUIYLS)	销户柜员流水号		
XIOHGY	R	REFFLD(GUIYDH)	销户柜员		
XJDCJE	R	REFFLD(JIOYJE)	现金调出金额		
SHKRZH	R	REFFLD(DUIFZH)	收款人帐号		
SKHHAO	R	REFFLD(LIANHH)	收款行号		
XJDCBS	R	REFFLD(BISHUU)	现金调出笔数		
SHKRXM	R	REFFLD(KEHZWM)	收款人姓名		
PZHTJH	A	8	凭证提交号		
LZBWZT	A	1	来帐报文状态		
SHFYHB	A	1	是否英联邦货币		
HZFFJE	R	REFFLD(JIOYJE)	汇总发放金额		
HZKAZL	A	4	合作卡种类		
DLFKHH	R	REFFLD(JIAOHH)	代理付款行行号		
ZHC1FS	A	1	转存方式		
KAZZDM	A	6	卡组织代码		
DLFKHM	O	42	代理付款行名称		
HTNGBH	A	16	合同编号		
CXCFXX	A	250	查询查复信息		
WEITHM	A	8	委托号码		
WEITZT	A	1	委托状态		
BISHUU	P	7	笔数		
HBENJE	R	REFFLD(JIOYJE)	还本金额		
SHHUDH	A	10	商户号		
HZHEYY	A	1	换折原因		
DAIFJS	R	REFFLD(JISHUU)	贷方积数		
DAIFSE	P	18	2	贷方发生额	
DAIFYE	R	REFFLD(ZHHUYE)	贷方余额		
DAIFBS	R	REFFLD(BISHUU)	贷方笔数		
FDBUMN	A	4	放贷部门		
BQHKRQ	R	REFFLD(RIQIII)	本期还款日期		
YWKABZ	A	1	有无卡标识		
KAAAZL	A	1	卡种类		
KAAADJ	A	1	卡等级		
JLJGDH	R	REFFLD(YNGYJG)	建立机构代号		
KAAADX	A	1	卡对象		
JNLIGY	R	REFFLD(GUIYDH)	建立柜员		
KAAALX	A	1	卡类型		
XINDGY	R	REFFLD(GUIYDH)	信贷柜员		
XNJNJE	R	REFFLD(JIOYJE)	现金金额		
QISPZH	P	8	起始凭证号		
DUIFRQ	R	REFFLD(RIQIII)	兑付日期		
ZHZPZH	P	8	终止凭证号		
DFZZRQ	R	REFFLD(RIQIII)	兑付终止日期		
JIECHS	R	REFFLD(KAIHSH)	结存户数		
CHMCHJ	R	REFFLD(CHMRUJ)	钞卖价		
KXNGYT	O	42	款项用途		
DAIZJE	R	REFFLD(ZHHUYE)	贷方总金额		
KNGZYE	R	REFFLD(ZHHUYE)	控制余额		
DAIZBS	R	REFFLD(BISHUU)	贷方总笔数		
CHUIBZ	A	1	钞汇标志		
CHSHDM	A	4	城市代码		
ZHSHZT	A	1	证书状态		
ZHSHLX	A	1	证书类型		
KEHUZH	A	20	客户帐号		
KEHUJM	A	10	客户简名		
LNXIRM	O	22	联系人		
FKLXRM	A	8	发卡联系人		
KEHUXM	A	22	客户姓名		
KEHZWM	O	62	客户中文名		
KEHHAO	A	10	客户号		
KHFWZL	A	2	客户服务种类		
WQKHZT	A	1	网银签约客户状态		
KEHUXH	A	8	客户序号		
DNGQCC	R	REFFLD(YDRZCC)	当前场次		
KEHULB	A	1	客户类别		
DUIHFS	A	1	兑换方式		
HZHECS	R	REFFLD(HNKACS)	换折次数		
BWBIZL	A	1	本外币种类		
HUOBMC	A	12	贷币名称		
HUOBDH	A	2	货币代号		
HUOBDJ	A	1	货币等级		
BIZHLY	A	7	币种来源		
HUOBFH	A	3	货币符号		
QBIEDW	A	9	券别单位		
RIJYXE	R	REFFLD(JIOYJE)	日交易限额		
RIQIII	Q	日期		
XIOZLX	A	1	销帐类型		
ZDKZBZ	A	1	自动扣帐标志		
DXCZBZ	R	REFFLD(XIOZLX)	待销帐操作标志		
XIOZXH	A	17	销帐序号		
RIIIII	A	2	日		
JIEFBS	R	REFFLD(BISHUU)	借方笔数		
TIEXZH	R	REFFLD(ZHANGH)	贴现帐号		
ZHEJJE	R	REFFLD(JIOYJE)	折价金额		
JDJKBZ	A	1	借贷记卡标志		
TIEXLL	R	REFFLD(LILVLL)	贴现利率		
CJYWBH	R	REFFLD(JIEJUH)	拆借业务编号		
HQYBTH	A	12	活期一本通号		
SBSHBM	A	6	送表设备名		
DRHXBZ	A	1	当日核销标志		
CUNKZL	A	2	存款种类		
JIEFJS	R	REFFLD(JISHUU)	借方积数		
JIEFSE	P	18	2	借方发生额	
FZHSZH	R	REFFLD(ZHANGH)	发展商帐号		
JIEFYE	R	REFFLD(ZHHUYE)	借方余额		
FZHSMC	R	REFFLD(KEHZWM)	发展商名称		
FZSKHH	R	REFFLD(KEHHAO)	发展商客户号		
BUMENN	A	2	部门		
CKLXRM	A	8	存款联系人		
MZHIZH	R	REFFLD(ZHANGH)	面值帐号		
MZZHYE	R	REFFLD(ZHHUYE)	面值帐号余额		
PIOMJE	R	REFFLD(JIOYJE)	票面金额		
CHAEJE	R	REFFLD(JIOYJE)	差额		
ZHEJZH	R	REFFLD(ZHANGH)	折价帐号		
ZJZHYE	R	REFFLD(ZHHUYE)	折价帐户余额		
JFXIBZ	A	1	计复息标志		
ZHQUCS	P	2	支取次数		
YXFFGL	R	REFFLD(JIOYJE)	已宣告发放股利		
DLLHHH	R	REFFLD(LIANHH)	代理联行行号		
DLLHHM	R	REFFLD(HNGMNG)	代理联行行名		
ZSFZYY	A	1	证书废止原因		
XJDWZH	R	REFFLD(ZHANGH)	下级单位帐号		
XJIKHH	R	REFFLD(KEHHAO)	下级客户号		
DNGQLX	R	REFFLD(JIOYJE)	定期利息		
SQBMBH	A	1	申请部门编号		
DNGQBH	R	REFFLD(ZHAOXH)	定期编号		
HUIPJE	R	REFFLD(JIOYJE)	汇票金额		
HUIPMY	A	8	汇票密押		
RUNNBZ	A	1	闰年标志		
WYDNYU	A	255	网银DN域		
JIEZJE	R	REFFLD(ZHHUYE)	借方总金额		
JIEZBS	R	REFFLD(BISHUU)	借方总笔数		
RIIILL	R	REFFLD(LILVLL)	日利率		
SHUMYJ	A	16	数码印鉴		
CHUPRQ	R	REFFLD(RIQIII)	出票日期		
XBYEHS	P	3	下半页行数		
TIANSH	P	8	天数		
MCGHJE	R	REFFLD(JIOYJE)	每次归还金额		
HPSQSH	R	REFFLD(PNGZHH)	汇票申请书号码		
JNGJXZ	A	5	经济性质		
ZZHIRQ	R	REFFLD(RIQIII)	终止日期		
FXZZRQ	R	REFFLD(RIQIII)	发行终止日期		
ZZHIHM	P	4	终止号码		
SFJYZM	A	1	是否有教育证明		
SXIORQ	R	REFFLD(RIQIII)	生效日期		
DZYJDZ	A	42	E_MAIL地址		
JSYJBZ	A	1	接收EMAIL标志		
YGNGBH	A	8	员工编号		
YWENDZ	A	30	英文地址		
BQQMYE	R	REFFLD(ZHHUYE)	本期期末余额		
QIYEDM	A	20	企业代码		
YWENMC	A	80	英文名称		
GYRJBZ	A	1	柜员日结标记		
WTSKBH	A	8	委托收款编号		
NDJSPJ	R	REFFLD(PAIJIA)	年度决算牌价		
ZZHILS	R	REFFLD(GUIYLS)	终止流水号		
WSPJZL	A	1	委托收款票据种类		
MYTXJE	R	REFFLD(JIOYJE)	每月摊销金额		
MCJSBS	N	每次接收笔数		
CWJYXH	N	错误交易序号		
WTDWZH	R	REFFLD(ZHANGH)	委托单位帐号		
SFOBBZ	A	1	是否欧洲货币标志		
MCZQJE	R	REFFLD(JIOYJE)	每次支取金额		
JIEJUH	A	16	借据号		
HUIDJE	R	REFFLD(JIOYJE)	汇兑金额		
JIOHRQ	R	REFFLD(RIQIII)	交换日期		
JIAOHH	A	9	交换号		
PAIJIA	P	12	6	牌价	
JIOHLX	A	1	交换类型		
RUZHRQ	R	REFFLD(RIQIII)	入帐日期		
JIZHFS	A	1	记帐方式		
RUZHCC	R	REFFLD(YDRZCC)	入帐场次		
RUZHSJ	R	REFFLD(SHJIAN)	入帐时间		
MIANEE	P	9	2	面额	
YQMRHL	R	REFFLD(PAIJIA)	远期买入汇率		
WAIHBZ	A	1	外汇标志		
WHXKHM	A	16	外汇许可证号码		
SHIJLL	R	REFFLD(LILVLL)	实际利率		
QNGSFS	A	1	清算方式		
DQYBTH	R	REFFLD(HQYBTH)	定期一本通号		
YQJGRQ	R	REFFLD(RIQIII)	远期交割日		
SJZDMB	A	60	数据字段名称列表		
YQIIHL	R	REFFLD(PAIJIA)	远期汇率		
SXZCZH	R	REFFLD(ZHANGH)	手续费支出帐号		
FEIYNG	R	REFFLD(JIOYJE)	费用		
SHXFJE	R	REFFLD(JIOYJE)	手续费金额		
QUXIFS	A	1	取息方式		
FEILDC	P	10	费率挡次		
SSXFBZ	A	1	收手续费标志		
FENHDM	A	2	分行代码		
SBRZJE	R	REFFLD(JIOYJE)	失败入帐金额		
SBRZWJ	A	32	失败入帐文件名		
YLYLZL	R	REFFLD(LILVBH)	一类逾期利率种类		
WENJMC	A	32	文件名		
WJDKFL	A	1	五级贷款分类		
FUBIJW	A	3	铺币进位		
YLYQZH	R	REFFLD(ZHANGH)	一类逾期帐号		
LVFDBZ	A	1	利率上浮/下浮标志		
YYQXZH	R	REFFLD(ZHANGH)	表内一类逾期欠息帐号		
YYQYWH	R	REFFLD(YEWUDH)	一类逾期本金科目业务代号		
LLFDBL	P	9	7	利率浮动比例	
SBRZBS	R	REFFLD(BISHUU)	失败入帐笔数		
SHFUJE	R	REFFLD(JIOYJE)	实付金额		
SHFULX	R	REFFLD(JIOYJE)	实付利息		
CJIEXH	R	REFFLD(ZHAOXH)	拆借序号		
SHSHJE	R	REFFLD(JIOYJE)	实收金额		
JSHHBZ	A	1	结售汇标志		
SHSHLX	R	REFFLD(JIOYJE)	实收利息		
JIEHZL	A	1	结汇种类		
FEILZL	A	2	费率种类		
YQMCHL	R	REFFLD(PAIJIA)	远期卖出汇率		
QTAILS	A	12	前台流水号		
WTJJZH	R	REFFLD(ZHANGH)	委托单位基金帐号		
YYSYWH	R	REFFLD(YEWUDH)	表内一类逾期贷款应收利息科目业务代号		
WHMMFS	A	1	外汇买卖方式		
CZHENH	A	15	传真号码		
WET1ZT	A	1	委托状态		
DJIEJE	R	REFFLD(JIOYJE)	冻结金额		
DJIEYE	R	REFFLD(ZHHUYE)	冻结余额		
ZHIFBM	R	REFFLD(KEHZWM)	执法部门		
DJIELX	A	1	冻结类型		
ZHIFRY	R	REFFLD(KEHUXM)	执法人员		
DJIESH	A	20	冻结书号		
TSCFBH	A	16	托收编号		
TUIPRQ	R	REFFLD(RIQIII)	退票日期		
TRJFHZ	R	REFFLD(ZHHUYE)	提入借方汇总		
TRJFBS	R	REFFLD(BISHUU)	提入借方笔数		
DBGPBH	A	10	代管品编号		
FAZHRQ	R	REFFLD(RIQIII)	发折日期		
FAZHYH	A	4	发折银行		
TRDFHZ	R	REFFLD(ZHHUYE)	提入贷方汇总		
TRDFBS	R	REFFLD(BISHUU)	提入贷方笔数		
QTUISJ	R	REFFLD(SHJIAN)	签退时间		
JTKHBZ	A	1	集团客户标志		
GUASRQ	R	REFFLD(RIQIII)	挂失日期		
GUASGY	R	REFFLD(GUIYDH)	挂失柜员		
SKDWZH	R	REFFLD(DUIFZH)	收款单位帐号		
BZHJZH	R	REFFLD(ZHANGH)	保证金帐号		
FFNGJE	R	REFFLD(JIOYJE)	发放金额		
YJTILX	R	REFFLD(JIOYJE)	已计提利息		
HUIPLX	A	1	汇票类型		
HUIPBH	R	REFFLD(WTSKBH)	汇票编号		
HUIPZT	A	1	汇票状态		
SDRZJE	R	REFFLD(JIOYJE)	手动入帐金额		
SDRZBS	R	REFFLD(DRTHBS)	手动入帐笔数		
SJGEYE	R	REFFLD(ZHHUYE)	上级行国债额度分户余额		
SHJIHM	R	REFFLD(HNGMNG)	上级行名		
ZUIGJE	R	REFFLD(JIOYJE)	最高金额		
TISHXI	A	62	提示信息		
JIARII	R	REFFLD(RIQIII)	假日		
CHYYFS	R	REFFLD(CUNQII)	持有月份数		
BLIUYE	R	REFFLD(ZHHUYE)	保留余额		
CDXYBH	A	16	承兑协议编号		
YCHPZT	A	1	银行承兑汇票状态		
ZHUJRQ	R	REFFLD(RIQIII)	主机日期		
GUAZJE	R	REFFLD(JIOYJE)	挂帐金额		
GZCLRQ	R	REFFLD(RIQIII)	挂帐处理日期		
GUAZBS	R	REFFLD(DRTHBS)	挂帐笔数		
GZCLZT	R	REFFLD(LZBWZT)	挂帐处理状态		
JSCLBZ	A	1	即时处理标志		
RUZHBZ	A	1	入帐标志		
ZJZZLX	A	1	中间业务转入帐号类型		
JQMRHL	R	REFFLD(PAIJIA)	即期买入汇率		
WQZZLX	A	1	网银签约转入客户帐号类型		
ZJDJDZ	R	REFFLD(DIZHII)	证件登记地址		
DZBYWH	R	REFFLD(YEWUDH)	呆滞本金科目业务代号		
ZHJHAO	A	20	证件号码		
ZHJNZL	A	1	证件种类		
FAZJIG	O	62	发证机关		
TZHIJE	R	REFFLD(JIOYJE)	通知金额		
TZHIRQ	R	REFFLD(RIQIII)	通知日期		
YWUDHM	R	REFFLD(KEHZWM)	业务代号名		
YWDHLY	A	10	业务代号来源		
TZHIZT	A	1	通知状态		
TZHIGY	R	REFFLD(GUIYDH)	通知柜员		
TZGYLS	R	REFFLD(GUIYLS)	通知柜员流水号		
ZHIYJE	R	REFFLD(JIOYJE)	质押金额		
TZSYZL	A	1	投资收益种类		
JQJGRQ	R	REFFLD(RIQIII)	即期交割日		
XNGMMC	O	42	项目名称		
DZYWBH	A	10	抵质押物编号		
ZHIYLV	R	REFFLD(LILVLL)	质押率		
DZHYLX	A	1	抵质押类型		
LXSRZH	R	REFFLD(ZHANGH)	利息收入帐号		
YLZHYE	R	REFFLD(ZHHUYE)	应收利息帐户余额		
BENQLX	R	REFFLD(JIOYJE)	本期利息		
DRGZYE	R	REFFLD(ZHHUYE)	调入行国债额度分户余额		
DRWXYE	R	REFFLD(ZHHUYE)	调入尾箱余额		
JIXIFF	A	1	计息方法		
GERZWM	R	REFFLD(KEHUXM)	个人中文名		
HBZMSX	A	3	货币字母缩写		
GERYWM	A	20	个人英文名		
JIXIYF	A	1	计息与否		
XINXNR	A	50	信息内容		
LLBHLX	A	1	利率编号类型		
JIXIZQ	A	1	计息周期		
GUOXBZ	A	1	过息标志		
DIORHM	R	REFFLD(HNGMNG)	调入行名		
LILVBH	A	3	利率编号		
JXI1ZQ	A	1	计息周期		
LLTYRS	A	4	利率调整月日数		
LILVLL	P	9	7	利率	
LLTZFS	A	1	利率调整方式		
LLBHZT	A	1	利率编号状态		
LIXILX	R	REFFLD(JIOYJE)	利息		
YNGSLX	R	REFFLD(JIOYJE)	应税利息		
DIORJG	A	4	调入机构号		
XJSFBZ	A	1	现金收付标记		
CRWDBZ	A	1	出入网点标记		
FDNGLL	R	REFFLD(LILVLL)	浮动利率		
FANFLL	R	REFFLD(LILVLL)	反方利率		
JQMCHL	R	REFFLD(PAIJIA)	即期卖出汇率		
YWU3LX	A	3	业务类型		
BAOXZL	A	5	保险种类		
KEMUCC	A	1	科目存储		
FENHSY	A	1	分行适用		
YEWUDH	A	4	业务代号		
XMU1NR	A	42	项目内容		
XNGMNR	A	42	项目内容		
KMUHAO	A	6	科目号		
ZNGHSY	A	1	总行适用		
KEMUMC	O	42	科目名称		
MEYZSJ	R	REFFLD(PAIJIA)	美元折算价		
XNGMFH	A	10	项目符号		
XMU1LB	A	1	项目类别		
XNGMLB	A	1	项目类别		
KEMULB	A	1	科目类别		
ZHIHSY	A	1	支行适用		
TOUZZL	A	1	投资种类		
TOUZCB	R	REFFLD(JIOYJE)	投资成本		
TOUZLB	A	3	投资类别		
TOUZMC	A	42	投资名称		
TOUZBH	R	REFFLD(JIEJUH)	投资编号		
JIEGRQ	R	REFFLD(RIQIII)	解挂日期		
JIEGGY	R	REFFLD(GUIYDH)	解挂柜员		
JIEKRQ	R	REFFLD(RIQIII)	解控日期		
JIEKGY	R	REFFLD(GUIYDH)	解控柜员		
KEFOGS	R	REFFLD(CAOZBZ)	可否挂失		
LEIBIE	A	1	类别		
ZHHUZL	A	2	帐户种类		
LJIFKE	R	REFFLD(JIOYJE)	累计放款额		
SHQIYE	R	REFFLD(ZHHUYE)	上期余额		
YIFFHS	N	已发放户数		
ZHJYRQ	R	REFFLD(RIQIII)	最后财务交易日		
XECLBZ	A	1	限额处理标志		
DAIKZL	A	2	贷款种类		
ZONGED	R	REFFLD(ZHHUYE)	总额度		
DKLXMC	R	REFFLD(KEHZWM)	贷款类型名称		
DAIKLX	A	6	贷款类型		
XECZLX	A	1	限额操作类型		
DKH1LX	A	8	贷款行业类型1		
DKH2LX	A	8	贷款行业类型2		
DKH3LX	A	8	贷款行业类型3		
DKH4LX	A	8	贷款行业类型4		
DKH5LX	A	8	贷款行业类型5		
DKH6LX	A	8	贷款行业类型6		
DKH7LX	A	8	贷款行业类型7		
DKH8LX	A	8	贷款行业类型8		
XJNKYE	R	REFFLD(ZHHUYE)	现金库余额		
XHDQBH	R	REFFLD(ZHAOXH)	下级行定期编号		
SQDFYE	R	REFFLD(ZHHUYE)	上期贷方余额		
XJKHMC	R	REFFLD(KEHZWM)	下级客户名称		
KHXKEH	A	16	开户许可证号码		
SQJCHS	R	REFFLD(KAIHSH)	上期结存户数		
XHCJXH	R	REFFLD(ZHAOXH)	下级行拆借户序号		
HUICJE	R	REFFLD(JIOYJE)	汇差金额		
SQJFYE	R	REFFLD(ZHHUYE)	上期借方余额		
NBFHXH	A	6	内部分户序号		
LDJYDM	A	4	联动交易码		
DKRZZH	R	REFFLD(ZHANGH)	贷款入帐帐号		
SCJYRQ	R	REFFLD(RIQIII)	上次交易日		
CHANGD	P	5	长度		
XECZZQ	A	1	限额充值周期		
XECZRQ	A	10	限额充值日期		
XECZFS	A	1	限额充值方式		
DZHIZH	R	REFFLD(ZHANGH)	呆滞帐号		
CYHHAO	A	4	成员行号		
ZHYONR	A	256	摘要内容		
CYHNGM	R	REFFLD(HNGMNG)	成员行名		
SCJXRQ	R	REFFLD(RIQIII)	上次计息日		
EDOOJE	R	REFFLD(JIOYJE)	额度		
ZZHAOM	A	32	执照号码		
SSJYRQ	R	REFFLD(RIQIII)	上上次交易日		
HTNGJE	R	REFFLD(ZHHUYE)	合同金额		
DAIKXZ	A	1	贷款性质		
DAIKXS	A	1	贷款形式		
ZUIDJE	R	REFFLD(JIOYJE)	最低金额		
ZCZHXH	R	REFFLD(ZHAOXH)	支出帐号序号		
ZCYWDH	R	REFFLD(YEWUDH)	支出业务代号		
QDAOSJ	R	REFFLD(SHJIAN)	签到时间		
DNGLMM	A	16	登录密码		
DKCXFS	A	1	贷款查询方式		
FRENMC	O	22	法人名称		
SCYEFX	R	REFFLD(YUEEFX)	上次余额方向		
GUASYH	A	2	挂失银行		
DAXLEI	A	1	大类/细类		
SHYDXZ	R	REFFLD(XIOZXH)	上一待销帐		
SHCZXR	R	REFFLD(RIQIII)	上次转息日		
LCUNCS	R	REFFLD(ZHQUCS)	漏存次数		
DKHYLX	A	8	贷款行业类型		
LNGYGY	R	REFFLD(GUIYDH)	领用柜员		
DAOQRQ	R	REFFLD(RIQIII)	到期日		
ZHFKBZ	A	1	主附卡标志		
ZXJZDW	P	5	最小记帐单位		
ZXHBDW	P	5	最小货币单位		
YJAJJS	R	REFFLD(JISHUU)	应加/减积数		
FYJJJS	R	REFFLD(JISHUU)	反方应加/减积数		
YJAJLX	R	REFFLD(JIOYJE)	应加/减利息		
FYJJLX	R	REFFLD(JIOYJE)	反方应加/减利息		
ZNGFHS	R	REFFLD(XBYEHS)	中缝行数		
ZHNGJJ	R	REFFLD(PAIJIA)	中间价		
YJIOSJ	R	REFFLD(JIOYJE)	应缴税金		
TZQXBZ	A	1	通知/取消标志		
TNGZZL	A	1	通知种类		
YYCWDM	A	7	应用错误代码		
PTCWXH	P	10	平台错误序号		
BEIZXX	A	42	备注信息		
CUOWXX	A	82	错误信息		
ZYZCZH	R	REFFLD(ZHANGH)	中间业务转出帐号		
WYZHLX	A	1	外围业务帐户类型		
ZYYSQH	N	中间业务预授权号		
ZYWWTH	N	中间业务委托号		
ZYWTZT	A	1	中间业务委托状态		
QCUNJE	R	REFFLD(JIOYJE)	起存金额		
ZYZRZH	R	REFFLD(ZHANGH)	中间业务转入帐号		
CHULZT	A	1	处理状态		
ZUIDWS	A	1	最低位数		
ZIJNQX	A	1	资金去向		
ZIJNXZ	A	1	资金性质		
GNLIMS	A	1	管理模式		
ZHCDXH	A	1	主菜单序号		
ZIJNLY	A	1	资金来源		
YUEEEE	A	2	月		
BWZHYE	R	REFFLD(ZHHUYE)	表外帐户余额		
AJXMMC	R	REFFLD(KEHZWM)	按揭项目名称		
AJXMBH	A	16	按揭项目编号		
ZHUZZH	R	REFFLD(ZHANGH)	主帐号		
DJJDBZ	A	1	冻结/解冻标志		
ZHUKAH	R	REFFLD(KAHAOO)	主卡号		
WEIHRQ	R	REFFLD(RIQIII)	维护日期		
ZUICQX	N	最长期限		
WHGYLS	R	REFFLD(GUIYLS)	维护柜员流水号		
WEIHGY	R	REFFLD(GUIYDH)	维护柜员		
BUJXJE	R	REFFLD(JIOYJE)	不计息金额		
BUJXTS	N	不计息天数		
XNPZHH	R	REFFLD(PNGZHH)	新凭证号		
GUOZBH	A	20	国债编号		
GUOZQS	A	2	国债期数		
XCUNDH	R	REFFLD(PNGZHH)	新存单号		
GUOZZL	A	1	国债种类		
YHUIZL	A	1	押汇种类		
YHUIBH	A	20	押汇编号		
YHUILX	A	1	押汇类型		
XINDMM	R	REFFLD(JIOYMM)	新密码		
BNBNZH	R	REFFLD(ZHANGH)	表内本年帐号		
BNBNQX	R	REFFLD(ZHHUYE)	表内本年欠息额		
BUJXRQ	R	REFFLD(RIQIII)	不计息日期		
B1JXTS	R	REFFLD(TIANSH)	不计息天数		
LXKYWH	R	REFFLD(YEWUDH)	利息科目业务代号		
ZDLLZL	R	REFFLD(LILVBH)	正常贷款利率种类		
XNGMPY	A	30	姓名拼音		
BWBNZH	R	REFFLD(ZHANGH)	表外本年帐号		
BWBNQX	R	REFFLD(ZHHUYE)	表外本年欠息额		
DYCLBZ	A	1	打印处理标志		
XNFKRM	O	40	新付款人名称		
XNFKZH	R	REFFLD(ZHANGH)	新付款人帐号		
XIAYXZ	R	REFFLD(XIOZXH)	下一待销帐		
TPYTFS	A	1	同城票交远郊退票方式		
SHULNG	N	数量		
PNGZZS	R	REFFLD(SHULNG)	凭证张数		
XYTXRQ	R	REFFLD(RIQIII)	下一调息日		
ZHNGSH	P	5	张数		
XNKHUH	R	REFFLD(KEHHAO)	新客户号		
XCJYRQ	R	REFFLD(RIQIII)	下次交易日		
XYDYHS	R	REFFLD(XBYEHS)	下一打印行数		
ZZCZLX	A	1	中间业务转出帐号类型		
BWZHZH	R	REFFLD(ZHANGH)	表外帐号		
MBIOSJ	A	128	目标数据		
BWSFSE	R	REFFLD(JIOYJE)	表外收发生额		
BWSHBS	R	REFFLD(BISHUU)	表外收笔数		
KXHUBZ	A	1	开销户标志		
YQB1LX	R	REFFLD(JIOYJE)	逾期本金利息		
YNPZHH	R	REFFLD(PNGZHH)	原凭证号		
YQBJLX	P	16	8	逾期本金利息	
BWFFSE	R	REFFLD(JIOYJE)	表外付发生额		
BWFUBS	R	REFFLD(BISHUU)	表外付笔数		
YUQIBJ	R	REFFLD(JIOYJE)	逾期本金		
JIUKHH	A	13	旧客户号		
YJIAZH	R	REFFLD(ZHANGH)	溢价帐号		
BANGDZ	O	62	办公地址		
YJIAJE	R	REFFLD(JIOYJE)	溢价金额		
YJZHYE	R	REFFLD(ZHHUYE)	溢价帐户余额		
BANGDH	A	15	办公电话		
TQLXJE	R	REFFLD(JIOYJE)	拖欠利息金额		
BWLYWH	R	REFFLD(YEWUDH)	表外应收利息科目业务代号		
JUPZHH	A	8	旧凭证号码		
JIUDMM	R	REFFLD(JIOYMM)	旧密码		
KHJSZH	R	REFFLD(DUIFZH)	在开户行结算帐号		
KAIHJE	R	REFFLD(JIOYJE)	开户金额		
KAIHHM	R	REFFLD(HNGMNG)	开户行名		
KAIHRQ	R	REFFLD(RIQIII)	开户日期		
CAOZBZ	A	1	操作标志		
CAOZUO	A	10	操作		
CZYNJB	A	1	操作员级别		
WYCZYM	R	REFFLD(KEHUXM)	网银操作员名		
CZYNXH	A	2	操作员序号		
KHJGDH	R	REFFLD(YNGYJG)	开户机构代号		
KAIHSH	P	6	开户数		
KAIHYH	A	4	开户银行		
CZYNZT	A	1	操作员状态		
KAIHGY	R	REFFLD(GUIYDH)	开户柜员		
CKOUZL	A	1	敞口种类		
KHGYLS	R	REFFLD(GUIYLS)	开户柜员流水号		
LEBIE1	A	1	类别		
KA1HGY	R	REFFLD(GUIYDH)	开户柜员		
YSHQGY	R	REFFLD(GUIYDH)	原授权柜员		
YSKRMC	O	42	原收款人名称		
YNGYLS	R	REFFLD(GUIYLS)	原柜员流水号		
DUIFZH	A	32	对方帐号		
DSYHDZ	R	REFFLD(DIZHII)	第三方用户地址		
DUIFJE	R	REFFLD(JIOYJE)	对方金额		
DSFHTH	A	6	第三方合同号		
DSFPBZ	A	1	第三方发票标志		
GUIFHH	R	REFFLD(LIANHH)	对方行号		
BIOWWX	A	4	表外尾箱		
DFYWDH	R	REFFLD(YEWUDH)	对方业务代号		
DFPZHH	A	13	对方凭证号		
DFHBDH	R	REFFLD(HUOBDH)	对方货币代号		
DSMQBZ	A	1	第三方明细清单标志		
DSYHBH	A	30	第三方用户编号		
DSQTXX	A	20	第三方其它信息		
DFAKMH	R	REFFLD(KMUHAO)	对方科目号		
DSDZYX	A	20	第三方电子邮箱		
CHPRQC	R	REFFLD(HNGMNG)	出票人全称		
DUIFMC	R	REFFLD(KEHZWM)	对方名称		
DSYHMM	A	16	第三方用户密码		
DFJGDH	R	REFFLD(YNGYJG)	对方机构代号		
DFJGMC	R	REFFLD(HNGMNG)	对方机构名称		
DFYBTH	R	REFFLD(YBENTH)	对方一本通帐号		
DSYHDH	R	REFFLD(DIANHH)	第三方用户电话		
BCZOGY	R	REFFLD(GUIYDH)	被操作柜员		
DFZWJG	R	REFFLD(YNGYJG)	对方帐务机构代号		
DSYHYB	R	REFFLD(YOUZBM)	第三方用户邮编		
LXZCZH	R	REFFLD(ZHANGH)	利息支出帐号		
DCGZYE	R	REFFLD(ZHHUYE)	调出行国债分户余额		
DIOCHM	R	REFFLD(HNGMNG)	调出行名		
WZBWZT	A	1	往帐报文状态		
DIOCJG	A	4	调出机构号		
TOUZJS	R	REFFLD(JISHUU)	透支积数		
TOUZBZ	A	1	透支标志		
TOUZJE	R	REFFLD(ZHHUYE)	透支余额		
FUKNJE	R	REFFLD(JIOYJE)	付款金额		
FUKRZH	R	REFFLD(DUIFZH)	付款人帐号		
HUKNFS	A	1	还款方式		
KFJZBZ	A	1	可否记帐		
FUKRMC	R	REFFLD(KEHZWM)	付款人名称		
MNZHII	P	9	2	面值	
HUILUU	A	1	汇路		
DAMZHI	R	REFFLD(JIOYJE)	大面值		
SKD1ZH	R	REFFLD(ZHANGH)	收款单位帐号		
SJYWZT	A	30	算校验位主体		
FUKNHM	R	REFFLD(HNGMNG)	付款行名		
BENPLX	A	1	本票类型		
KZHEBZ	A	1	折卡标志		
MMJYBZ	A	1	密码校验标志		
DKGLMC	A	42	贷款归类名称		
DKGLBH	A	4	贷款归类编号		
BAIFBL	P	3	百分比		
CHLISX	P	5	处理顺序		
TCJFHZ	R	REFFLD(ZHHUYE)	提出借方汇总		
TCJFBS	R	REFFLD(BISHUU)	提出借方笔数		
CUNQII	A	3	存期		
YOUHLL	R	REFFLD(LILVLL)	优惠利率		
CHXUMS	A	42	程序描述		
HUNXJE	R	REFFLD(JIOYJE)	还息金额		
DYN1BZ	A	1	打印标志		
PINNN1	A	16	PIN1		
PINNN2	R	REFFLD(PINNN1)	PIN2		
PINNN3	R	REFFLD(PINNN1)	PIN3		
PINNN4	R	REFFLD(PINNN1)	PIN4		
ZHQILL	R	REFFLD(LILVLL)	展期利率		
CZZPBZ	A	1	存折/支票户标志		
TCDFHZ	R	REFFLD(ZHHUYE)	提出贷方汇总		
TCDFBS	R	REFFLD(BISHUU)	提出贷方笔数		
KJSKRC	N	扣缴税款人次		
CHDKBZ	A	1	长短款标志		
CHDKYY	A	1	长短款原因		
SYZCJG	R	REFFLD(YNGYJG)	损益支出机构		
FUKNHH	R	REFFLD(LIANHH)	付款行号		
CANSHZ	A	8	参数值		
YNGWSM	A	20	英文说明		
CANSMC	A	10	参数名称		
FUKRXM	A	62	付款人姓名		
CANSSJ	A	10	参数数据		
CANSSM	A	20	参数说明		
HUKNZH	R	REFFLD(ZHANGH)	还款帐号		
YOUZBM	A	7	邮政编码		
ZHIWUU	A	10	职务		
ZHQIBZ	A	1	展期标志		
ZHQIZT	A	1	展期状态		
SRZHXH	R	REFFLD(ZHAOXH)	收入帐号序号		
SRZHYE	R	REFFLD(ZHHUYE)	上日帐户余额		
SRYEFX	R	REFFLD(YUEEFX)	上日余额方向		
SRZ1YE	R	REFFLD(ZHHUYE)	上日帐户余额		
DAYNSJ	A	80	打印数据		
ZHIYEE	A	1	职业		
YUSXBZ	A	1	预收息标志		
SRYWDH	R	REFFLD(YEWUDH)	收入业务代号		
SHFUBZ	A	1	收付标识		
ZUIGCS	N	最高成数		
JYCHXM	A	5	交易程序名		
DYNDLM	A	8	打印队列名		
DAYNLX	A	1	打印类型		
MM16MM	A	16	密码		
BMYNJN	A	12	变码印鉴		
MIMARQ	R	REFFLD(RIQIII)	密码日期		
YWZHBZ	A	10	有无折标识		
MM01MM	A	16	密码		
MM02MM	R	REFFLD(MM01MM)	密码		
JIOYMM	A	16	交易密码		
MM03MM	A	16	密码		
MM04MM	R	REFFLD(MM03MM)	密码		
MM05MM	R	REFFLD(MM03MM)	密码		
MM06MM	R	REFFLD(MM03MM)	密码		
BAOBLJ	A	80	报表路径		
YDNFEI	R	REFFLD(JIOYJE)	邮电费		
DAYNBZ	A	1	打印标志		
SFYMMF	A	1	是否需要密码封		
MMJYFS	A	1	密码校验方式		
DUF1JE	R	REFFLD(JIOYJE)	兑付金额		
ZHIFBZ	A	1	支付标志		
TUOSZL	A	1	托收种类		
EDDKBZ	A	1	额度贷款标志		
EGMRFS	A	1	额度管理默认方式		
XANEZL	A	5	限额种类		
QNSQZH	R	REFFLD(ZHANGH)	钱生钱帐号		
CHXJLH	P	10	查询记录号		
CXCFBH	R	REFFLD(WTSKBH)	查询查复编号		
CXCFZT	A	1	查询查复状态		
ZZPJGN	O	42	执照批准机关		
BILVED	A	1	比率/额度		
BILVVV	P	8	5	比率	
CDBJJE	R	REFFLD(JIOYJE)	偿还贷款本金户金额		
SHBOHH	R	REFFLD(LIANHH)	收报行号		
SHBHHH	R	REFFLD(LIANHH)	收报行行号		
SHBORQ	R	REFFLD(RIQIII)	收报日期		
DLHSBZ	A	1	独立核算标志		
SHBOHM	R	REFFLD(HNGMNG)	收报行名		
SKDWMC	O	62	收款单位名称		
TUIPLY	A	42	退票理由		
TUIPCC	R	REFFLD(YDRZCC)	退票场次		
EDXHJE	R	REFFLD(JIOYJE)	额度循环金额		
EDXHJG	A	1	额度循环间隔		
CXUNBS	P	2	查询笔数		
EDXHPY	P	10	额度循环偏移量		
EDXHFS	A	1	额度循环方式		
JNSHJY	A	256	减少交易		
XNGGZH	R	REFFLD(ZHANGH)	相关帐号		
ZHUCRQ	R	REFFLD(RIQIII)	注册日期		
ZHUCZJ	R	REFFLD(JIOYJE)	注册资金		
ZHUCBZ	A	1	注册标志		
BEIZHU	O	20	备注		
SHKHHM	R	REFFLD(HNGMNG)	收款行名		
ZZZCDZ	O	62	执照注册地址		
CBDLJE	R	REFFLD(JIOYJE)	偿还本期贷款利息金额		
SHXILX	A	1	收息类型		
QNFHHH	A	10	签发行行号		
QNFHHM	O	62	签发行行名		
GXJLQX	A	3	关系建立期限		
GNLNXH	A	1	关联序号		
CHPRZH	R	REFFLD(DUIFZH)	持票人帐号		
GSRZJH	R	REFFLD(ZHJHAO)	挂失人证件号码		
GSRZJL	R	REFFLD(ZHJNZL)	挂失人证件种类		
CHPRMC	R	REFFLD(KEHZWM)	持票人名称		
YUNXQJ	A	2	运行区间		
CBNLQX	R	REFFLD(ZHHUYE)	偿还表内累计欠息金额		
CBWLQX	R	REFFLD(ZHHUYE)	偿还表外累计欠息金额		
ZHXSXH	P	8	执行顺序号		
DIOYFS	A	1	调用方式		
BNGXBZ	A	1	并行标志		
BIOHAO	A	4	表号		
HUNKFS	A	1	还款方式		
XNGXSJ	O	12	详细时间		
YUQIZH	R	REFFLD(ZHANGH)	逾期帐号		
TUIHBZ	A	1	退汇标志		
CNLXFX	R	REFFLD(ZHHUYE)	偿还表内累计欠息当期复息金额		
HBXIFS	A	1	还本息方式		
TSZFJH	R	REFFLD(JIAOHH)	同城实时支付交换号		
CWLXFX	R	REFFLD(ZHHUYE)	偿还表外累计欠息当期复息金额		
TUIHSM	R	REFFLD(SHMING)	退汇说明		
HUILU1	A	1	汇路		
CUO1XX	A	50	错误信息		
BCHZBZ	A	1	被冲帐标志		
CHBUBZ	A	1	冲补标志		
HANGSH	N	行数		
SHKNBS	R	REFFLD(BISHUU)	收款笔数		
ZHCUNQ	A	3	转存期		
NFKHBZ	A	1	能否开户		
JIESBZ	A	1	结算方式		
CHUXLX	A	1	储蓄类型		
JGYYJB	A	1	机构营业级别		
JSHXMM	A	5	结售汇项目代码		
JGPZJB	A	1	机构凭证级别		
ZHHCLB	A	1	支行汇差类别		
JGGLJB	A	1	机构管理级别		
FABOHM	R	REFFLD(HNGMNG)	发报行名		
JIGOMC	R	REFFLD(HNGMNG)	机构中文名称		
JGYWMC	R	REFFLD(HNGMNG)	机构英文名称		
YNGYJG	A	4	营业机构号		
JGOHLY	R	REFFLD(YNGYJG)	机构号来源		
SHUNXH	A	4	顺序号		
ZHAIYO	A	20	摘要		
JHJGBZ	A	1	稽核机构标志		
FAKARQ	R	REFFLD(RIQIII)	发卡日期		
YJLXZE	R	REFFLD(ZHHUYE)	应计利息总额		
SDUILB	A	1	售兑类别		
FAKAYY	A	1	发卡原因		
FAKAGY	R	REFFLD(GUIYDH)	发卡柜员		
QYNGRQ	R	REFFLD(RIQIII)	启用日期		
PNGZHM	R	REFFLD(PNGZHH)	凭证号码		
XUHAO1	P	4	序号		
QNFARQ	R	REFFLD(RIQIII)	签发日期		
CGCLWJ	A	32	成功处理文件名		
EYLLZL	R	REFFLD(LILVBH)	二类逾期利率种类		
SJIOGY	R	REFFLD(GUIYDH)	上缴柜员		
DZSYZT	A	1	单式凭证使用状态		
MAICZH	R	REFFLD(ZHANGH)	卖出帐号		
MAICJE	R	REFFLD(JIOYJE)	卖出金额		
MCBIZH	A	2	卖出币种		
MAICHM	A	62	卖出户名		
MAICHJ	R	REFFLD(PAIJIA)	卖出价		
BHFFJE	R	REFFLD(JIOYJE)	本行发放金额		
ZHYODM	A	22	摘要代码		
ELYQZH	R	REFFLD(ZHANGH)	二类逾期帐号		
BRQXZH	R	REFFLD(ZHANGH)	表内二类逾期欠息帐号		
EBKYWH	R	REFFLD(YEWUDH)	二类逾期本金科目业务代号		
ZHIDRQ	R	REFFLD(RIQIII)	指定日期		
PCJYSX	n	批处理交易顺序		
ZHXHLY	A	7	帐号序号来源		
XUHOZL	A	20	序号种类		
YOUXRQ	R	REFFLD(RIQIII)	有效日期		
FUWUMM	R	REFFLD(JIOYMM)	服务密码		
XNGBIE	A	1	性别		
TNGJDM	A	8	统计代码		
XIOJJE	R	REFFLD(ZHHUYE)	小计金额		
QISHBS	P	4	起始笔数		
ZHUNGT	A	1	状态		
JILUZT	A	1	记录状态		
QIS1BS	N	起始笔数		
GDNGZQ	N	固定周期		
QISHRQ	R	REFFLD(RIQIII)	起始日期		
KFCSDG	R	REFFLD(CAOZBZ)	可否出售－公		
YSJNBZ	A	1	印花税缴纳标志		
JIZHLL	R	REFFLD(LILVLL)	基准利率		
QISHHM	P	4	起始号码		
KFCSDS	R	REFFLD(CAOZBZ)	可否出售－私		
HEJIJE	R	REFFLD(ZHHUYE)	合计金额		
YUANSJ	A	128	源数据		
GNGBFE	P	13	2	工本费	
DIJNBZ	A	1	抵减标识		
BEDYWH	R	REFFLD(YEWUDH)	表内二类逾期贷款应收利息科目业务代号		
YBENTH	A	12	一本通号		
WYFUWM	A	40	网银服务名		
WYFUWH	A	3	网银服务号		
WYFWZT	A	1	网银服务状态		
CUNKLB	A	1	存款类别		
JISHJE	R	REFFLD(JIOYJE)	计税金额		
ZHZHFS	A	1	转帐方式		
SJKBMC	A	5	数据库表名称		
ZZDFSE	P	15	2	转帐贷发生额		
ZZDFBS	R	REFFLD(BISHUU)	转帐贷方笔数		
LZHIZL	A	2	旅支种类		
TUOSBH	A	16	托收编号		
ZZJFSE	P	15	2	转帐借发生额		
JNRIGS	R	REFFLD(ZHHUYE)	今日共收		
ZZJFBS	R	REFFLD(BISHUU)	转帐借方笔数		
JNRIGF	R	REFFLD(ZHHUYE)	今日共付		
WTSHHM	R	REFFLD(PNGZHH)	委托书号码		
GYXJXE	R	REFFLD(JIOYJE)	柜员现金限额		
GUIYZT	A	1	柜员状态		
GYQYBZ	A	1	柜员启用标志		
GUIYDH	A	8	柜员代号		
CHAXMM	R	REFFLD(JIOYMM)	查询密码		
GYZZXE	R	REFFLD(JIOYJE)	柜员转帐限额		
GUIYLX	A	1	柜员类型		
SHMING	O	42	说明		
DBGUAH	A	10	电报挂号		
TUIHJE	R	REFFLD(JIOYJE)	退汇金额		
TCTDBZ	A	1	通存通兑标识		
DRTHBS	P	4	当日退汇笔数		
SHMUDM	A	3	税目代码		
BNQ1LX	R	REFFLD(JIOYJE)	表内欠息利息		
BNLJLX	R	REFFLD(ZHHUYE)	表内累计利息		
SHJIAN	N	时间		
SHMUMC	A	22	税目名称		
BNQXLX	P	16	8	表内欠息利息	
SFJTSY	A	1	是否计提投资收益		
SHOQKH	A	10	授权卡号		
QUKNRQ	R	REFFLD(RIQIII)	取款日期		
JJQGYM	O	22	交接前柜员姓名		
JJHGYM	O	22	交接后柜员姓名		
GUIYXM	O	22	柜员姓名		
DIANHH	A	15	电话号码		
GUIYJB	A	1	柜员级别		
GUIYLS	A	12	柜员流水号		
BENQZT	A	1	本期状态		
BENQQS	N	本期期数		
SHJNCH	P	16	时间戳		
ZHDNZT	A	1	终端状态		
ZONGJE	R	REFFLD(ZHHUYE)	总金额		
JNRIKC	R	REFFLD(ZHHUYE)	今日库存		
BWLJLX	R	REFFLD(ZHHUYE)	表外累计利息		
ZONGHS	P	5	总户数		
BWQ1LX	P	16	8	表外欠息利息	
ZNGWSJ	A	4	帐务上级		
PNGZSJ	A	4	凭证上级		
YESHHS	R	REFFLD(XBYEHS)	页首行数		
GNLISJ	A	4	管理上级		
JIOYXZ	A	1	交易性质		
ZUANZH	R	REFFLD(ZHANGH)	转帐帐号		
LJYXBZ	A	1	联机交易允许标志		
JIO1JE	R	REFFLD(JIOYJE)	交易金额		
JIAOYM	A	4	交易码		
JIOYBS	R	REFFLD(BISHUU)	交易笔数		
JIOYRQ	R	REFFLD(RIQIII)	交易日期		
LURURQ	R	REFFLD(RIQIII)	录入日期		
CHLIBZ	A	1	处理标志		
JYZBLB	A	120	交易组别列表
JIOYZB	A	2	交易组别		
JIOYZL	A	1	交易种类		
JIOYXE	R	REFFLD(JIOYJE)	交易限额		
JYGYDH	R	REFFLD(GUIYDH)	交易柜员代号		
JIOYLB	A	512	交易列表		
JIOYMS	A	1	交易模式		
JIOY1M	R	REFFLD(JIAOYM)	交易码		
YSQ1GY	A	8	预授权柜员号		
JIOYZM	A	2	交易子码		
JYJGDH	R	REFFLD(YNGYJG)	交易机构代号		
JIOYXH	N	交易序号		
JIOYSJ	R	REFFLD(SHJIAN)	交易时间		
TUOSYE	R	REFFLD(ZHHUYE)	托收余额		
RJIEBZ	A	1	日结标记		
DQJYLS	n	柜员当前交易流水号		
TUOSZT	A	1	托收状态		
ZZTXRQ	R	REFFLD(RIQIII)	再转贴现日期		
BIOTBZ	A	1	标题标识		
ZZTXGY	R	REFFLD(GUIYDH)	再转贴现柜员		
ZONGQS	N	总期数		
SHKNJE	R	REFFLD(JIOYJE)	税款金额		
YJSHJN	R	REFFLD(JIOYJE)	应缴税金		
SHUIZH	A	1	税种		
SHZHMC	A	22	税种名称		
LXSHSL	R	REFFLD(LILVLL)	利息税税率		
SJKHMC	R	REFFLD(KEHZWM)	上级客户名称		
QNXIBZ	A	2	欠息标志		
BNDYWH	R	REFFLD(YEWUDH)	表内正常贷款应收利息科目业务代号		
DKQXLX	A	1	贷款欠息户类型		
DANWEI	P	8	单位		
YUQILL	R	REFFLD(LILVLL)	逾期利率		
SJDWZH	R	REFFLD(ZHANGH)	上级单位帐号		
SHJKHH	R	REFFLD(KEHHAO)	上级客户号		
SHBYHS	R	REFFLD(XBYEHS)	上半页行数		
WEIDZS	P	3	未登折数		
GUIYSX	A	1	柜员属性		
JIO1GY	R	REFFLD(GUIYDH)	交易柜员		
DKYNGT	A	42	贷款用途		
ZHNGJG	A	4	帐务机构号		
CHPZXH	P	8	传票组序号		
CPZNXH	P	4	传票组内序号		
CHNNXH	P	4	承兑汇票组内序号		
KYNGJE	R	REFFLD(ZHHUYE)	可用金额		
QIXIRQ	R	REFFLD(RIQIII)	起息日		
SFYJDZ	A	1	是否有价单证		
YOUXHS	R	REFFLD(XBYEHS)	有效行数		
YOUXYS	A	4	有效页数		
ZHQURQ	R	REFFLD(RIQIII)	支取日期		
ZHFUTJ	A	1	支付条件		
JSWGZH	R	REFFLD(ZHANGH)	结算违规帐号		
JSWGJE	R	REFFLD(JIOYJE)	结算违规金额		
JSWGRQ	R	REFFLD(RIQIII)	结算违规日期		
JSWGLX	A	1	结算违规类型		
FUKNBS	R	REFFLD(BISHUU)	付款笔数		
WDZQLX	R	REFFLD(JIOYJE)	未到期债券利息		
GNGZQZ	R	REFFLD(BISHUU)	工作权重		
GNGZDW	O	62	工作单位		
ZHNGDH	A	5	终端号		
WEISZT	A	1	委收状态		
DCLIJE	R	REFFLD(JIOYJE)	待处理金额		
DCLIBS	R	REFFLD(DRTHBS)	待处理笔数		
GSXKLB	A	1	挂失新开类别		
RMBIJE	R	REFFLD(JIOYJE)	人民币金额		
NIANNN	A	4	年		
NYUELL	A	1	年/月利率		
FFNYLL	R	REFFLD(NYUELL)	反方年/月利率
NYLLBZ	R	REFFLD(NYUELL)	年月利率标志		
JIOYNZ	A	8	校验值		
MBIODZ	H	4	目标地址		
PTCWDH	A	7	错误代号		
PTCUWH	N	eusp错误号		
PTCWXX	A	82	eusp错误信息		
JIOYBZ	A	1	检验标志		
XXJSBZ	A	1	信息结束标志		
SHJBCD	n	数据包长度		
SJBSXH	P	6	数据包顺序号		
PNYIL1	N	偏移量1		
PNYIL2	N	偏移量2		
BOLIUW	A	1	保留位		
YNDIZH	H	4	源地址		
JYSJCD	N	交易数据包长度		
QANTLS	A	12	前台流水号		
DAIKZH	R	REFFLD(ZHANGH)	贷款帐号		
YNJYRQ	R	REFFLD(RIQIII)	原交易日期		
ZBIEMC	A	20	组别名称		
SSRYEF	R	REFFLD(YUEEFX)	上上日余额方向		
KXH1BZ	R	REFFLD(KXHUBZ)	开销户标志		
DXZHLX	A	1	待销帐类型		
PNGZCC	A	1	凭证存储		
DSTCKG	A	1	对私通存开关		
DSTDKG	A	1	对私通兑开关		
TCJTHZ	R	REFFLD(ZHHUYE)	提出借方退票汇总		
TCJTBS	R	REFFLD(BISHUU)	提出借方退票笔数		
TCDTHZ	R	REFFLD(ZHHUYE)	提出贷方退票汇总		
TCDTBS	R	REFFLD(BISHUU)	提出贷方退票笔数		
TRJTHZ	R	REFFLD(ZHHUYE)	提入借方退票汇总		
TRJTBS	R	REFFLD(BISHUU)	提入借方退票笔数		
TRDTHZ	R	REFFLD(ZHHUYE)	提入贷方退票汇总		
TRDTBS	R	REFFLD(BISHUU)	提入贷方退票笔数		
DQISXH	R	REFFLD(SHUNXH)	定期顺序号		
HQISXH	R	REFFLD(SHUNXH)	活期顺序号		
KHSHXF	R	REFFLD(JIOYJE)	跨行手续费		
CID2XX	A	40	磁道2信息		
CD22XX	R	REFFLD(CID2XX)	磁道2信息		
ZYWXYH	A	8	中间业务协议号		
ZZXDRQ	A	10	自动转帐相对日期		
JYDZLX	A	2	交易对帐类型		
SHOULX	R	REFFLD(JIOYJE)	税后利息		
SHKZLX	R	REFFLD(KHZHLX)	收款单位客户帐号类型		
YWU4LX	A	1	业务类型		
ZYDM01	A	4	摘要代码1		
ZYDM02	A	4	摘要代码2		
ZYDM03	A	4	摘要代码3		
ZYDM04	A	4	摘要代码4		
ZYDM05	A	4	摘要代码5		
ZYDM06	A	4	摘要代码6		
ZYDM07	A	12	摘要代码7		
ZYDM08	A	12	摘要代码8		
ZYDM09	A	4	摘要代码9		
ZYDM10	A	4	摘要代码10		
ZYDM11	A	8	摘要代码11		
ZYDM12	A	8	摘要代码12		
ZYJE01	R	REFFLD(JIOYJE)	摘要金额1		
ZYJE02	R	REFFLD(JIOYJE)	摘要金额2		
ZYJE03	R	REFFLD(JIOYJE)	摘要金额3		
ZYJE04	R	REFFLD(JIOYJE)	摘要金额4		
ZYJE05	R	REFFLD(JIOYJE)	摘要金额5		
ZYJE06	R	REFFLD(JIOYJE)	摘要金额6		
ZYJE07	R	REFFLD(JIOYJE)	摘要金额7		
ZYJE08	R	REFFLD(JIOYJE)	摘要金额8		
ZYJE09	R	REFFLD(JIOYJE)	摘要金额9		
ZYJE10	R	REFFLD(JIOYJE)	摘要金额10		
ZYJE11	R	REFFLD(JIOYJE)	摘要金额11		
ZYJE12	R	REFFLD(JIOYJE)	摘要金额12		
FJXX01	A	30	附加信息1		
FJXX02	A	30	附加信息2		
FJXX03	A	30	附加信息3		
FJXX04	A	30	附加信息4		
DNGJBH	A	12	冻结编号		
JIFENN	R	REFFLD(ZHHUYE)	积分		
GNGPZT	A	1	光票状态		
GYLXDM	A	2	柜员角色代码		
SJJY01	A	64	删减交易1		
SJJY02	A	64	删减交易2		
SJJY03	A	64	删减交易3		
SJJY04	A	64	删减交易4		
BHTHBZ	A	1	本行/他行标志		
TXYWZL	A	1	贴现业务种类		
GJZHLX	A	1	公积金帐户类型		
BZHJLX	A	1	保证金类型		
SNCDAO	A	107	三磁道		
CFYWZL	A	1	拆放业务种类		
CRYWZL	A	1	拆入业务种类		
CHJEZL	A	1	拆借种类		
TXNJJH	R	REFFLD(JIEJUH)	贴现借据号		
CJY1BH	R	REFFLD(JIEJUH)	拆借业务编号		
CXC1BH	R	REFFLD(WTSKBH)	查询查复编号		
BFXJZQ	R	REFFLD(JIOYJE)	部分现金支取		
BFXJCR	R	REFFLD(JIOYJE)	部分现金存入		
QUKNWD	R	REFFLD(YNGYJG)	取款网点		
QFHLHH	R	REFFLD(LIANHH)	签发行联行行号		
JIOYMC	A	32	交易名称		
STRZLX	A	1	收妥入帐类型		
SHFEBZ	A	1	收费标志		
QFHLHM	R	REFFLD(HNGMNG)	签发行联行行名		
FUHELX	A	1	复核类型		
HNKNFS	A	1	还款方式		
JIESFS	A	1	结算方式		
YOLUXZ	A	1	邮路选择		
HUIGZL	A	1	回购种类		
YJLXJE	R	REFFLD(ZHHUYE)	原应计利息余额		
YSLXJE	R	REFFLD(ZHHUYE)	原应收利息余额		
BZLTSY	R	REFFLD(ZHHUYE)	本债券累计投资收益		
QUXJNG	P	2	取息间隔		
WSZFSE	R	REFFLD(JIOYJE)	金融往来收/支发生额		
BENPLB	R	REFFLD(HUIPLX)	本票类别		
TIEXBZ	A	1	贴现标志		
ZHQNZL	A	1	债券种类		
TOUZQX	A	3	投资期限		
SFYKHH	A	1	是否校验客户号		
NHGOZL	A	1	逆回购种类		
MCCHBZ	R	REFFLD(CHUIBZ)	卖出钞汇标识		
ZJYWZL	A	3	中间业务种类		
ZYSHDH	A	4	中间业务商户代号		
TIOZFX	A	1	调整方向		
CHZHRQ	R	REFFLD(RIQIII)	冲正日期		
PAIJLY	A	1	牌价来源		
FXNGND	A	4	发行年度		
BLGYLS	R	REFFLD(GUIYLS)	补充录入柜员流水号		
FHGYLS	R	REFFLD(GUIYLS)	复核柜员流水号		
RZGYLS	R	REFFLD(GUIYLS)	入帐柜员流水号		
GZGYLS	R	REFFLD(GUIYLS)	挂帐柜员流水号		
THGYLS	R	REFFLD(GUIYLS)	退汇柜员流水号		
TZSHFS	A	1	投资债券收回方式		
MZSSZE	R	REFFLD(ZHHUYE)	卖出债券实收总额		
BQSXJE	R	REFFLD(JIOYJE)	本期收息金额		
MZMZZE	R	REFFLD(ZHHUYE)	卖出债券面值总额		
MZYJHE	R	REFFLD(JIOYJE)	卖出债券溢价核减额		
MZZJHE	R	REFFLD(JIOYJE)	卖出债券折价核减额		
YLXHJE	R	REFFLD(JIOYJE)	应计(收)利息核减额		
BRTZSE	R	REFFLD(JIOYJE)	本次入帐投资收益额		
YCVVBZ	A	1	是否检查CVV标志		
GHRHZE	R	REFFLD(JIOYJE)	挂帐核销入帐汇总金额		
GHRHZS	P	4	挂帐核销入帐汇总笔数		
GHTHZE	R	REFFLD(JIOYJE)	挂帐核销退汇汇总金额		
GHTHZS	P	4	挂帐核销退汇汇总笔数		
LJTZJE	R	REFFLD(ZHHUYE)	累计通知金额		
ZHXXLY	A	1	帐号相关信息来源		
RZHZXH	A	5	日志子序号		
RIZHXH	A	25	日志序号		
ZRZHXZ	R	REFFLD(ZHHUXZ)	转入帐户性质		
FDNGLX	A	1	浮动类型		
FUDNGZ	R	REFFLD(LILVLL)	浮动值		
FHDMA1	R	REFFLD(FENHDM)	分行代码		
FHDMA2	R	REFFLD(FENHDM)	分行代码		
PNG1ZL	R	REFFLD(PNGZZL)	凭证种类		
PNG2ZL	R	REFFLD(PNGZZL)	凭证种类		
PNG1PH	R	REFFLD(PNGZPH)	凭证批号		
PNG2PH	R	REFFLD(PNGZPH)	凭证批号		
PNG1XH	R	REFFLD(PNGZXH)	凭证序号		
PNG2XH	R	REFFLD(PNGZXH)	凭证序号		
GZG1LS	R	REFFLD(GUIYLS)	挂帐柜员流水号		
HXGYLS	R	REFFLD(GUIYLS)	核销柜员流水号		
YUNXFS	R	REFFLD(JIGOLX)	运行方式		
HTSQBZ	A	1	后台授权标志		
XANEYE	R	REFFLD(ZHHUYE)	限额余额		
FAKAFS	A	1	发卡方式		
JRZHBZ	A	1	记日志标志		
GUAZBZ	A	1	挂帐标志		
PNGCFX	A	1	平仓方向		
DNGJJB	R	REFFLD(GUIYDH)	冻结经办员		
DNGJFH	R	REFFLD(GUIYDH)	冻结复核员		
DNGJSQ	R	REFFLD(GUIYDH)	冻结授权员		
JDNGRQ	R	REFFLD(RIQIII)	解冻日期		
JDNGJB	R	REFFLD(GUIYDH)	解冻经办员		
JDNGFH	R	REFFLD(GUIYDH)	解冻复核员		
JDNGSQ	R	REFFLD(GUIYDH)	解冻授权员		
JDNGGY	R	REFFLD(GUIYDH)	解冻柜员		
OYUJSJ	R	REFFLD(PAIJIA)	欧元结算价		
IPMMBZ	A	1	重置非主叫IP密码标识		
ZJDHBZ	A	1	重置主叫电话号码标识		
ZCZHZD	A	6	转出帐号字段名		
QHSQBZ	A	1	前后台授权标志		
QXRJCH	A	6	起息日检查字段名		
FDLLJC	A	6	浮动利率检查字段名		
SXEDBH	A	16	授信额度编号		
CZFLBS	P	4	被冲正会计分录笔数		
CZDJBS	P	4	被冲正登记簿记录笔数		
KHZHBZ	A	1	客户帐户标志		
ZDNGLL	R	REFFLD(PAIJIA)	指定汇率		
PIPELL	R	REFFLD(PAIJIA)	匹配汇率		
ZHISHL	R	REFFLD(PAIJIA)	止损汇率		
WEITHL	R	REFFLD(PAIJIA)	委托汇率		
TCHTCH	A	20	同城提出号		
GNGXRQ	R	REFFLD(RIQIII)	更新日期		
GNGXSJ	R	REFFLD(SHJIAN)	更新时间		
KEHUXZ	A	1	客户性质		
CHJHTH	A	6	成交合同号		
CJIORQ	R	REFFLD(RIQIII)	成交日期		
CJIOSJ	R	REFFLD(SHJIAN)	成交时间		
CJIOHL	R	REFFLD(PAIJIA)	成交汇率		
WETHTH	R	REFFLD(CHJHTH)	委托合同号		
WET1RQ	R	REFFLD(RIQIII)	委托日期		
WEITSJ	R	REFFLD(SHJIAN)	委托时间		
GMYSYH	A	3	工作密钥的索引号		
GNGZMY	A	16	工作密钥		
JIOYMY	A	16	校验密钥		
KAITBZ	A	1	开通标志		
GPCXFS	A	1	挂盘查询方式		
MXCXFS	A	1	明细查询方式		
IPYWLX	A	1	IP业务类型		
CXCFLX	A	1	查询查复类型		
TUIHRQ	R	REFFLD(RIQIII)	退汇日期		
JSZHLX	A	1	结算帐户类型		
SXEDZH	R	REFFLD(ZHANGH)	授信额度帐号		
GZMYJY	A	4	工作密钥校验值		
WMJYFS	A	1	外汇买卖交易方式		
WLYWBZ	A	1	外围落地业务处理标志		
YATMBZ	A	1	异地支行ATM联网标志		
YPOSBZ	A	1	异地支行POS联网标志		
BYBZ01	A	1	备用标志1		
BYBZ02	A	1	备用标志2		
BYBZ03	A	1	备用标志3		
BYBZ04	A	1	备用标志4		
SXEDLX	A	1	授信额度类型		
SXEDPZ	A	2	授信额度品种		
SXFFRQ	R	REFFLD(RIQIII)	授信发放日期		
SCTZRQ	R	REFFLD(RIQIII)	上次调整日期		
EDOOXE	R	REFFLD(JIOYJE)	额度限额		
EDOOYE	R	REFFLD(ZHHUYE)	额度余额		
EDOFSE	R	REFFLD(JIOYJE)	额度发生额		
DIK1ZH	R	REFFLD(ZHANGH)	贷款帐号		
DK0FSE	R	REFFLD(JIOYJE)	贷款发生额		
DK1FSE	R	REFFLD(ZHHUYE)	贷款发生额		
DKSYTS	R	REFFLD(TIANSH)	贷款使用天数		
CSKSRQ	R	REFFLD(RIQIII)	初始开始日期		
CSZZRQ	R	REFFLD(RIQIII)	初始终止日期		
CSJSZH	R	REFFLD(ZHANGH)	初始结算帐号		
CSLLFD	R	REFFLD(LLFDBL)	初始利率浮动率		
CSXEBZ	A	1	初始限额标志		
XANEBZ	A	1	限额标志		
SFBKHD	A	1	是否包括还清贷款		
SCJ2RQ	R	REFFLD(RIQIII)	上次交易日期		
EDJYLB	A	2	额度交易类别		
EDKJLB	A	2	额度贷款交易类别		
CSZHLX	R	REFFLD(KHZHLX)	初始帐号类型		
HZEDXE	R	REFFLD(JIOYJE)	汇总额度限额		
HZSYED	R	REFFLD(JIOYJE)	汇总使用额度		
HZEDYE	R	REFFLD(ZHHUYE)	汇总额度余额		
TIOZJE	R	REFFLD(JIOYJE)	调整金额		
TZKSTS	R	REFFLD(RIQIII)	调整开始日期		
TZZZRQ	R	REFFLD(RIQIII)	调整终止日期		
TZZHLX	R	REFFLD(KHZHLX)	调整帐号类型		
TZJSZH	R	REFFLD(ZHANGH)	调整结算帐号		
TZLLFD	R	REFFLD(LLFDBL)	调整利率浮动率		
TIOZRQ	R	REFFLD(RIQIII)	调整日期		
TIOZGY	R	REFFLD(GUIYDH)	调整柜员		
XINEBZ	R	REFFLD(XANEBZ)	限额标志		
SXCXFS	A	1	授信查询方式		
DMYXBZ	A	1	当日抹帐允许标志		
GMYXBZ	A	1	隔日抹帐允许标志		
PZJCBZ	A	1	平帐检查标志		
CZGYLS	R	REFFLD(GUIYLS)	错帐柜员流水号		
CUOZJY	R	REFFLD(JIAOYM)	错帐交易		
CZJYMC	R	REFFLD(JIOYMC)	错帐交易名称		
SXSYJE	R	REFFLD(ZHHUYE)	授信使用金额		
ZHSXBZ	A	1	转授信标志		
EDKYJE	R	REFFLD(JIOYJE)	额度可用余额		
CXYWLX	A	1	撤消业务类型		
CBZHBZ	A	1	冲补帐标志		
ZDQSBZ	A	1	自动清算标志		
HLZIBZ	A	1	红蓝字标志		
GUASBZ	R	REFFLD(CAOZBZ)	挂失标志		
ZIDNLX	A	1	字段类型		
ZIDYWM	A	6	字段英文名		
JIOYFS	A	40	交易方式		
YWU5LX	A	40	业务类型		
WAIHXZ	A	20	外汇性质		
LEBIE2	A	20	类别		
SHGDDM	A	10	上海股东代码		
SZGDDM	A	10	深圳股东代码		
QNSHDH	A	2	券商代号		
SQYYDH	A	6	券商营业部代号		
PQPHBZ	A	1	批前批后处理标志		
SBBUZH	A	1	失败步骤		
GPIOSC	A	1	股票市场		
QNGSBZ	A	1	清算标志		
ZHJLBZ	A	1	主记录标志		
ZHKZFS	A	1	帐号控制方式		
JDFKFS	A	1	借贷方向控制方式		
JEKZFS	A	1	金额控制方式		
JGKZFS	A	1	机构控制方式		
FENHLB	A	300	分行列表		
JIGOLB	A	300	机构列表		
TDYWZL	A	2	天地对接业务种类		
YULZ01	A	50	预留字段		
YULZ02	A	50	预留字段		
YULZ03	A	50	预留字段		
YULZ04	A	50	预留字段		
YULZ05	A	50	预留字段		
YULZ06	A	50	预留字段		
YULZ07	A	50	预留字段		
YULZ08	A	50	预留字段		
XINX01	A	60	信息		
XINX02	A	60	信息		
XINX03	A	60	信息		
XINX04	A	60	信息		
XINX05	A	60	信息		
XINX06	A	60	信息		
XINX07	A	60	信息		
XINX08	A	60	信息		
XINX09	A	60	信息		
XINX10	A	60	信息		
XINX11	A	60	信息		
XINX12	A	60	信息		
LUR1RQ	R	REFFLD(RIQIII)	录入日期		
XJYRBZ	A	1	写交易日志标志		
TXDZ01	A	30	通讯地址1		
TXDZ02	R	REFFLD(TXDZ01)	通讯地址2		
TXDZ03	R	REFFLD(TXDZ01)	通讯地址3		
TXDZ04	R	REFFLD(TXDZ01)	通讯地址4		
TXDZ05	R	REFFLD(TXDZ01)	通讯地址5		
DZLX01	N	地址类型1		
DZLX02	R	REFFLD(DZLX01)	地址类型2		
DZLX03	R	REFFLD(DZLX01)	地址类型3		
DZLX04	R	REFFLD(DZLX01)	地址类型4		
DZLX05	R	REFFLD(DZLX01)	地址类型5		
IPDIZH	A	15	IP地址		
ZIZHGY	A	8	自助柜员代号		
ZIZHJG	A	4	自助机构代号		
FHIPDZ	R	REFFLD(IPDIZH)	分行IP地址		
FHPORT	A	4	分行PORT号		
FENZXH	A	2	封装序号		
FENZLX	A	1	封装类型		
GJZILB	A	100	关键字列表		
CWXXDY	A	300	错误信息定义		
ZWENMC	A	80	中文名称		
PYINMC	A	80	拼音名称		
YJISHU	R	REFFLD(JISHUU)	月积数		
RJISHU	R	REFFLD(JISHUU)	日积数		
SJKEMU	R	REFFLD(KMUHAO)	上级科目		
KEMUJB	R	REFFLD(JIBIEE)	科目级别		
NIANLI	N	年龄		
WAIWBH	A	3	外围业务编号		
TCJHRQ	R	REFFLD(RIQIII)	提出交换日期		
TCJHCC	P	1	提出交换场次		
TRJHRQ	R	REFFLD(RIQIII)	提入交换日期		
TRJHCC	P	1	提入交换场次		
PIOJFS	A	1	票交方式		
DAILBZ	A	1	代理标志		
SJXLXX	A	1	数据项类型		
SHUJUX	A	256	数据项		
JISHBZ	A	1	计算标志		
SHUCBZ	A	1	输出标志		
YXJLTS	N	有效记录条数		
RMBIYE	R	REFFLD(ZHHUYE)	人民币余额		
HZCXFS	A	1	汇总查询方式		
NIAFEN	A	4	年份		
YUEFEN	A	2	月份		
WECNZL	R	REFFLD(SXINZL)	伪残种类		
JJXJJE	R	REFFLD(ZHHUYE)	借方帐户借方现金发生额		
JDXJJE	R	REFFLD(ZHHUYE)	借方帐户贷方现金发生额		
JJZZJE	R	REFFLD(ZHHUYE)	借方帐户借方转帐发生额		
JDZZJE	R	REFFLD(ZHHUYE)	借方帐户贷方转帐发生额		
DJXJJE	R	REFFLD(ZHHUYE)	贷方帐户借方现金发生额		
DDXJJE	R	REFFLD(ZHHUYE)	贷方帐户贷方现金发生额		
DJZZJE	R	REFFLD(ZHHUYE)	贷方帐户借方转帐发生额		
DDZZJE	R	REFFLD(ZHHUYE)	贷方帐户贷方转帐发生额		
DLJGHH	R	REFFLD(YNGYJG)	代理机构号		
RHJSBZ	A	1	人行结算标志		
DUIFGY	R	REFFLD(GUIYDH)	对方柜员		
DBQFBZ	A	1	代办签发标志		
KEHUXE	R	REFFLD(JIOYJE)	客户限额		
DAIKKH	A	20	贷款卡号		
DGDSBZ	A	1	对公对私标志		
ZHEJKM	A	6	折价科目		
JYIFZR	R	REFFLD(KEHZWM)	交易负责人		
KA1MMA	R	REFFLD(JIOYMM)	卡密码		
XINZHH	A	24	新帐号		
QISKAH	R	REFFLD(KAHAOO)	卡起始号		
ZHZKAH	R	REFFLD(KAHAOO)	卡终止号		
GQGLZH	R	REFFLD(ZHANGH)	股权管理专户		
SSZBZH	R	REFFLD(ZHANGH)	实收资本帐户		
CHGUJE	R	REFFLD(JIOYJE)	持股金额		
GUQNZH	A	6	股权证号		
CHGULX	A	1	持股类型		
GUDNGM	R	REFFLD(KEHZWM)	股东名称		
DNGJRQ	Q	登记日期		
ZRNGJE	R	REFFLD(JIOYJE)	转让金额		
ZRNGRQ	Q	转让日期		
GQCXLX	A	1	股权查询类型		
HLCXLX	A	1	红利查询类型		
GUQNZT	A	1	股权状态		
HNGLZT	A	1	红利状态		
MEIGJZ	R	REFFLD(JIOYJE)	每股价值		
HONGLV	R	REFFLD(LILVLL)	红利率		
FNHNPH	A	6	分红批号		
SNGGPH	R	REFFLD(FNHNPH)	送股批号		
FHRIQI	R	REFFLD(RIQIII)	分红日期		
YNGDHL	R	REFFLD(JIOYJE)	应得红利		
HNGLJE	R	REFFLD(JIOYJE)	红利金额		
GDNKHH	R	REFFLD(KEHHAO)	股东客户号		
SNGGSL	R	REFFLD(SHULNG)	送股数量		
ZRNGGY	R	REFFLD(GUIYDH)	转让柜员		
SNGUGY	R	REFFLD(GUIYDH)	送股柜员		
SNGURQ	R	REFFLD(RIQIII)	送股日期		
LNQURQ	R	REFFLD(RIQIII)	领取日期		
LNQUGY	R	REFFLD(GUIYDH)	领取柜员?	
CHIGSL	R	REFFLD(SHULNG)	持股数量		
ZHURSL	R	REFFLD(SHULNG)	转让数量		
SHIDHL	R	REFFLD(JIOYJE)	实得红利		
DAIKSJ	R	REFFLD(JIOYJE)	待扣税金		
KOUSBL	R	REFFLD(LLFDBL)	扣税比例		
SNGGBL	R	REFFLD(LLFDBL)	送股比例		
HLLYZT	R	REFFLD(JILUZT)	红利领用状态		
DKSYLX	A	2	贷款所有制类型		
DKHGLX	A	2	贷款行业类型		
DKYTLX	A	2	贷款用途类型		
DKXQLX	A	2	贷款期限类型		
DKFSLX	A	2	贷款方式类型		
FAKAJG	R	REFFLD(YNGYJG)	发卡机构		
KAYYBZ	A	20	卡已用标志		
KUANBI	A	2	款别		
KHAOXH	A	7	卡号序号		
HANGYL	A	4	行业类别		
XINYDJ	A	2	信用等级		
RIZHYT	A	1	日志用途		
GJZIQZ	A	100	关键字取值		
SJDJXH	N	事件登记序号		
YCUNQX	A	1	移存去向		
BANBIE	A	4	版别		
JEXIZQ	A	3	结息周期		
JITIZQ	A	3	计提周期		
FLSJDN	N	费率时间段		
DKJTBL	P	9	7	计提比例	
WNJGJB	A	1	万能交易机构级别		
CQUKXZ	A	1	存取款性质		
CQUKXE	P	13	2	存取款限额	
KEHLAX	A	1	客户类型		
KEHUZT	A	1	客户状态		
SUSHGJ	A	40	所属国家		
SUSUDQ	A	40	所属地区		
CWZHUG	A	22	财务主管		
KATUOR	A	8	开拓人		
GUOJII	A	40	国籍		
JINNBZ	A	1	是否境内居民		
FZJGDQ	A	40	发证机关国家		
DANWXZ	A	1	单位性质		
DANWYB	A	7	单位邮编		
XLYXRQ	Q	税率有效日期		
ZHICHE	A	1	职称		
XUELII	A	1	学历		
FUNYCK	A	1	婚姻情况		
ZINUCK	A	1	子女情况		
YUESUR	P	15	2	月收入	
ZZAIDZ	A	40	住宅地址		
LXDIAH	A	16	联系电话		
KHGXLB	A	1	客户关系类别		
GUQUBL	P	9	7	股权比例	
KHGXQX	A	1	客户关系权限		
DBGPZL	A	2	有价代保管品种类		
FENPFS	A	1	分配方式		
GUDJIE	P	15	2	固定金额	
BILIII	P	9	7	比例	
KAZHON	A	1	卡种类		
JINBAN	A	8	经办人员		
JBJIGU	A	4	经办机构		
XHJIGU	A	4	销毁机构		
SFJDZD	A	1	是否寄对单帐		
JIDAFS	A	1	寄单方式		
TOUZED	P	13	2	透支额度	
SHOJHM	A	15	手机号码		
TOUZLL	P	9	7	透支利率	
SHOUXZ	A	20	收息帐户		
WHZGED	P	15	2	外汇帐户的最高额度	
KFJJBZ	A	1	开放式基金标志设置		
ZJXHLX	A	1	资金下划类型		
DSHZZQ	A	1	定时划转周期		
DSHZRQ	A	8	定时划转日期		
DSHZJE	P	13	2	定时划转金额	
SXSFFS	A	1	手续费收费方式		
SXFLLX	A	1	手续费率类型		
SHXFLV	P	13	2	手续费率	
ZJSHLX	A	1	资金上划类型		
FENTGZ	A	1	分摊规则		
FUDFSI	A	1	浮动方式		
YUQFSI	A	1	逾期计息方式		
LTIZZQ	A	1	利率调整周期		
SXFFSI	A	1	手续费计收方式		
YTBHAO	A	20	银团编号		
YCJIJE	P	15	2	参加金额	
YZONJE	P	15	2	银团借款总额	
BAOLBZ	A	1	是否保理贴现标志		
GDJXFS	A	1	个人贷款计息方式		
FBZJBL	P	6	3	发展商保证金比例	
FBZJZH	A	20	发展商保证金帐号		
JIAOXE	P	13	2	余额限额	
MYJSBZ	A	1	是否做贸易结算		
BIZHON	A	2	币种		
KAHAO2	A	20	卡号		
FAKADM	A	8	发卡行代码		
FKAJGH	A	4	发卡机构号		
FAKAHM	A	40	发卡行名称		
YUOXRQ	Q	有效期		
ZHIKRQ	Q	制卡日期		
SHULIA	N	数量		
FUHERN	A	8	复核人员		
XIAOHR	A	8	销毁人员		
JINBRQ	Q	经办日期		
FUHERQ	Q	复核日期		
XFRIQI	Q	销毁日期		
ZHFUED	P	13	2	支付限额	
ZHFUMM	A	16	支付密码		
ZFMMBZ	A	1	支付密码使用标志		
GSCLPH	A	13	挂失处理编号		
GSGYLS	A	12	挂失交易柜流水号		
GSRIQI	Q	挂失日期		
JGGYLS	A	12	解挂交易柜流水号		
JGRIQI	Q	解挂日期		
PINZHH	A	8	凭证号		
FUWUZL	A	2	服务种类		
KEHUHO	A	10	客户号		
KEHULX	A	1	客户类别		
KEHJLI	A	8	客户经理		
TZSJLX	A	4	通知事件类型		
BTZRLX	A	1	被通知人类型		
BTZRDH	A	10	被通知人代号		
TOZIQD	A	1	通知渠道		
TZMBDZ	A	60	通知目标地址		
TNGZBH	A	10	通知编号		
CHNCFS	A	1	存储方式		
TNGZNR	A	256	通知内容		
TNGZRQ	A	8	通知日期		
TNGZSJ	N	通知时间		
SJTZRQ	A	8	实际通知日期		
SJTZSJ	N	实际通知时间		
BAOWBH	A	16	报文编号		
MT200A	R	REFFLD(BAOWBH)	MT200报文编号1		
MT200B	R	REFFLD(BAOWBH)	MT200报文编号2		
MT202A	R	REFFLD(BAOWBH)	MT202报文编号1		
MT202B	R	REFFLD(BAOWBH)	MT202报文编号2		
MT300A	R	REFFLD(BAOWBH)	MT300报文编号1		
MT300B	R	REFFLD(BAOWBH)	MT300报文编号2		
MT320A	R	REFFLD(BAOWBH)	MT302报文编号1		
MT320B	R	REFFLD(BAOWBH)	MT302报文编号2		
BICCOD	A	11	银行BIC号码		
SQHBIC	R	REFFLD(BICCOD)	申请行BIC号码		
ZJHBIC	R	REFFLD(BICCOD)	中间行BIC号码		
ZHHBIC	R	REFFLD(BICCOD)	帐户行BIC号码		
RZHBIC	R	REFFLD(BICCOD)	我入帐行BIC号码		
CZHBIC	R	REFFLD(BICCOD)	我出帐行BIC号码		
WCZHZH	R	REFFLD(ZHANGH)	我出帐行帐号		
WRZHZH	R	REFFLD(ZHANGH)	我入帐行帐号		
SQHGZH	R	REFFLD(ZHANGH)	申请行帐号		
ZJHGZH	R	REFFLD(ZHANGH)	中间行帐号		
ZHHGZH	R	REFFLD(ZHANGH)	帐户行帐号		
ZHAQJC	A	10	债券简称		
HGYWBH	R	REFFLD(JIEJUH)	债券回购业务编号		
ZHAQSL	R	REFFLD(JIOYJE)	债券数量		
JIQIJG	R	REFFLD(JIOYJE)	即期价格		
JUQIJG	R	REFFLD(JIOYJE)	远期价格		
ZQLXGS	A	1	债券利息归属		
HUIGZK	R	REFFLD(LLFDBL)	回购折扣		
JIQIJE	R	REFFLD(JIOYJE)	即期交割金额		
ZHIFFS	A	1	支付方式		
HUIGLL	R	REFFLD(LILVLL)	回购利率		
JIXIJC	A	1	计息基础		
YUQIJE	R	REFFLD(JIOYJE)	远期交割金额		
CJYWLX	A	1	拆借业务类型		
CJDSLX	A	1	拆借对手类型		
JYDSDM	A	12	交易对手代码		
WZQZHH	A	12	我行债券帐户行		
DZQZHH	A	12	对手债券帐户行		
DSZQZH	A	24	对手债券帐号		
WZJZHH	R	REFFLD(BICCOD)	我行资金帐户行		
WHZJZH	R	REFFLD(DSZQZH)	我行资金帐号		
DZJZHH	R	REFFLD(BICCOD)	对手资金帐户行		
DSZJZH	R	REFFLD(DSZQZH)	对手资金账号		
DRHGLX	A	1	头寸调拨调入行类型		
DRHBIC	R	REFFLD(BICCOD)	头寸调拨调入行BIC号码		
DBYWBH	R	REFFLD(JIEJUH)	调拨业务编号		
FKPZHM	R	REFFLD(BAOWBH)	人民币付款凭证号码		
YLYWBH	R	REFFLD(JIEJUH)	展期原业务编号?	
DIAWLX	A	2	电文类型		
BAOWLS	A	16	报文流水号		
BAOWLX	A	5	报文类型		
BAOWLY	A	1	报文来源		
BAOWNX	P	3	报文内序号		
BAOWQX	A	4	报文去向		
BAOWZT	A	1	报文状态		
BKEBZH	A	1	BKE标志		
BSFYWM	A	80	标记符英文名称		
BSFZWM	A	40	标记符中文名称		
BWJZBZ	A	1	记帐类报文标志		
BWMXBZ	A	1	报文明细标志		
CPHBIC	R	REFFLD(BICCOD)	出票行		
DAFNZH	A	17	贷方帐号		
DIAWBH	A	3	电文编号		
DIAWHH	P	3	电文行号		
DIAWLS	A	15	电文流水号		
DIAWMC	A	40	电文名称		
DIAWNR	A	70	电文内容		
DIWNBH	A	5	选用电文		
FBHBIC	R	REFFLD(BICCOD)	发报行BIC		
FBHYWH	A	16	发报行业务编号		
FEIFZF	A	80	非法字符		
FEIMLB	A	2	业务种类		
FEIYCD	A	5	费用负担		
FEIYCL	A	5	费用处理		
FUYANM	A	14	附言（码）		
GDBWLS	R	REFFLD(BAOWLS)	勾对报文流水号		
GDBWNX	P	3	勾对报文内序号		
GESHII	A	15	格式		
GJPJDH	A	20	国际票据号		
GUOJDM	A	3	国家代码		
GXYNSF	A	1	关系算符		
HRHBIC	A	11	划入行BIC	
HUIKBH	A	16	汇款编号		
HUIKFS	A	2	汇款方式		
HXIOSJ	A	8	核销时间		
HZDZFS	P	5	行最大字符数		
JNNWBZ	A	1	境内外标志		
JZBWBZ	A	1	记帐类报文标志		
KHHBIC	A	11	开户银行BIC		
MOBIAZ	A	1	必/选（M/O）标志		
QISIYE	P	15	2	起始余额	
RXXGBZ	A	1	允许修改标志		
SBHBIC	A	11	收报行BIC		
SYHBIC	A	11	受益人银行BIC		
TAGBZZ	A	3	Tag标记符		
TNGBBZ	A	1	同步标志		
TONGZBH	A	12	通知编号		
TUOSTH	A	16	票据托收套号		
WAIGCH	A	6	外管业务参号		
WAIGTJ	A	10	外管统计选项		
XNGGBH	A	16	相关业务编号		
YEWUBH	A	16	业务编号		
YHCHIP	A	11	银行	CHIPS代码	
YNHBIC	A	11	银行SWIFT	BIC码	
YNHYWM	A	50	银行英文名称		
YNHZWM	A	50	银行中文名称		
YNWDZ1	A	35	英文地址1		
YNWDZ2	A	35	英文地址2		
YNWDZ3	A	35	英文地址3		
YOUHBL	P	6	5	手续费优惠比例	
YUYWMC	A	80	域英文名称		
YUZWMC	A	40	域中文名称		
ZDZIFS	P	5	最大字符数		
ZHGMYE	P	15	2	帐面余额	
ZHHBSH	A	11	帐户行标识		
ZJSHBM	A	15	中间行识别代码		
ZUIDHS	P	3	最大行数		
CHULRQ	Q	托收处理日期		
QIXIRI	Q	起息日		
PIOJZT	A	1	票据状态		
DBJYMS	A	1	交易模式		
SQHSXG	A	4	申请行属性		
CBZHFS	A	1	冲补帐方式		
SFTZJS	A	1	是否调整积数		
FUDNYE	P	13	2	浮动余额	
DQKZZE	P	15	2	定期质押控制额	
WHBKZE	P	15	2	外汇宝控制总额	
BWZTXX	A	60	报文状态信息		
HUAZBZ	A	1	划转标志		
ZHYABZ	A	1	质押标志		
MADIBZ	A	1	买跌标志		
DBYWBZ	A	1	多笔业务标志		
BDBZZZ	A	1	变动标志		
BIAOZI	A	1	标志(增加、减少)		
CKZGXE	P	15	2	存款最高限额	
CUNKBZ	A	1	是否开通此功能		
CXRQQQ	A	8	撤消日期		
CXYYYY	A	40	撤消原因		
DQBHAO	A	2	地区号		
DQZDYE	P	15	2	当期最低余额	
DXUHAO	N	序号		
FWBZZZ	A	1	发往标志		
GJKBZZ	A	1	国际卡标志		
GLLLLL	A	4	功能		
JFKRQ	A	8	逻辑发卡日期		
JIAORQ	A	8	交易日期		
JIULBZ	A	1	记录标志		
KAAAXZ	A	1	卡性质		
KAITRQ	A	8	开通日期		
KDETXH	N	卡大额圈提序号		
KHQKCS	N	当期跨行取款次数(自然月)		
KLXBHH	A	10	卡类型编号		
KXETXH	N	卡小额圈提序号		
KYLJJE	P	15	2	卡的月消费透支累计金额(自然月)	
KZGUIY	A	8	控制柜员		
LEIXIN	A	1	类型		
LJTZED	P	15	2	联机透支额度	
MTDZJE	P	15	2	每天的总金额	
PINPBZ	A	1	品牌标志(VISA/MASTER)		
POSHAO	A	20	POS编号		
QDMSSS	A	2	渠道描述		
QKZGXE	P	15	2	取款最高限额	
QUDAOO	A	2	渠道		
QUXBZZ	A	1	功能描述		
SCBGXX	A	40	输出报告信息		
SCCWXX	A	40	输出错误信息		
SCRQQQ	A	8	生成日期		
SCYYYY	A	40	生成原因		
SFKNFF	A	1	是否自动扣年费		
SFKSXF	A	1	是否自动扣手续费		
SFKTQD	A	1	是否开通此渠道		
SFTZBZ	A	1	是否允许透支标志		
SFXCCC	A	1	是否下传		
SFZDXK	A	1	是否自动续卡(国际卡)		
SFZDXQ	A	1	是否自动续期		
SHBHAO	A	10	商户号		
TJTZED	P	15	2	脱机透支额度	
TOUZRQ	A	8	透支日期		
WEIFRQ	A	8	维护日期		
WFGUIY	A	8	维护柜员		
XIACXH	N	下传类型序号		
XIAOJE	P	15	2	销减金额	
YHBKZE	P	15	2	外汇宝总额控制	
YKFKZS	N	已开附卡张数		
YLIUBZ	A	10	预留标志		
YUXFRQ	A	8	预消户日期		
WHEDBZ	A	1	外汇最高额度标志		
KXEXXH	N	卡小额消费序号		
KDEXXH	N	卡大额消费序号		
LJFKRQ	A	8	逻辑发卡日期		
QDINJE	R	REFFLD(JIOYJE)	起点金额		
YXIORQ	A	8	有效日期		
JIXIFS	A	1	计息方式		
LLFDFS	A	1	利率浮动方式		
LUYLAN	A	40	留言栏		
ZIXIRQ	A	8	止息日期		
DFGBIC	A	11	对方行BIC码		
GDGYLS	R	REFFLD(GUIYLS)	勾对柜员流水号		
FBCLBZ	A	1	辅币处理标志		
WYZHZT	A	2	违约帐户状态		
JJKTBZ	A	1	基金开通标志		
YZKTBZ	A	1	银证通开通标志		
WHKTBZ	A	1	外汇宝开通标志		
B1KTBZ	A	1	备用开通标志1		
B2KTBZ	A	1	备用开通标志2		
B3KTBZ	A	1	备用开通标志3		
B4KTBZ	A	1	备用开通标志4		
B5KTBZ	A	1	备用开通标志5		
JIEDDH	A	2	借贷代号		
DUISLX	A	1	交易对手类型		
HETGBH	A	12	合同编号		
JIXILX	A	1	计息类型		
JINBGY	R	REFFLD(GUIYDH)	经办柜员		
JIZGGY	R	REFFLD(GUIYDH)	记帐柜员		
JIEBGY	R	REFFLD(GUIYDH)	结办柜员		
JIEFGY	R	REFFLD(GUIYDH)	结复柜员		
JIEJGY	R	REFFLD(GUIYDH)	结记柜员		
MAIMPZ	A	1	买卖品种		
MARBIC	R	REFFLD(BICCOD)	帐户行BIC		
MACBIC	R	REFFLD(BICCOD)	帐户行BIC		
BIC1CD	R	REFFLD(BICCOD)	帐户行BIC		
BIC2CD	R	REFFLD(BICCOD)	帐户行BIC		
BIC3CD	R	REFFLD(BICCOD)	帐户行BIC		
HKHBIC	R	REFFLD(BICCOD)	付款银行BIC
HUO1DH	R	REFFLD(HUOBDH)	货币代号		
HUO2DH	R	REFFLD(HUOBDH)	货币代号		
ZJJIOY	R	REFFLD(GUIYDH)	资金交易员		
PPLEIX	A	1	外汇交易中心平盘类型		
MMPPLX	A	1	外汇买卖平盘类型		
Z1YWBH	R	REFFLD(YEWUBH)	资金业务编号		
Z2YWBH	R	REFFLD(YEWUBH)	资金业务编号		
Z3YWBH	R	REFFLD(YEWUBH)	资金业务编号		
Z4YWBH	R	REFFLD(YEWUBH)	资金业务编号		
Z5YWBH	R	REFFLD(YEWUBH)	资金业务编号		
ZJYWPZ	A	2	资金业务品种		
FKTJZH	A	35	付款途径帐号		
DCHGLX	A	1	头寸调拨调出行类型		
BTZRMC	A	62	被通知人名称		
FENBFS	A	1	分配方式		
JINEEE	R	REFFLD(ZHHUYE)	固定金额		
FUKUFS	A	1	付款方式		
DHZFZL	A	2	兑付种类(定活)		
PZYYBZ	A	50	凭证已用标志		
WEIYRQ	A	8	违约日期		
PJQSBH	A	15	票据起始编号		
PJZZBH	A	15	票据终止编号		
ZKPZBZ	A	1	重要空白凭证标志		
TUOSFS	A	1	托收方式		
KOUKRQ	R	REFFLD(RIIIII)	扣款日期		
FBAOZJ	P	13	2	发展商保证金额	
PNGZLX	A	1	凭证类型		
DUIZBZ	A	1	对帐标志		
YJKRGX	A	20	与借款人关系		
DUSBIC	R	REFFLD(BICCOD	交易对手BIC		
QIXIAN	A	6	期限		
DXHKZL	A	1	待销毁卡种类		
BKOKRQ	A	8	本期扣款日期		
XINXWB	A	100	信息文本		
XEQCYE	P	15	2	小额圈存余额	
DEQCYE	P	15	2	大额圈存余额	
BEYJYE	P	15	2	备用金余额	
KHXNYW	A	1	新业务标志		
KHYWJB	A	2	考核业务级别		
KHYWLX	A	16	考核业务类型
KHSJLX	R	REFFLD(KHYWLX)	上级业务类型		
KHDKZH	N	存贷比分组号		
KHCDBS	R	REFFLD(BILIII)	比例区间下限		
KHCDSX	R	REFFLD(BILIII)	比例区间上限		
KHMNLL	R	REFFLD(LILVLL)	模拟利率		
KHYXJG	A	4	考核营销机构号		
KHDXLX	A	1	分配对象类型		
KHLRGL	A	1	利润关联类型		
KHFPZH	N	考核分配组号		
KHFENP	A	2	业绩分配方式		
KHRYHH	R	REFFLD(GUIYDH)	营销人员编号		
KONZBZ	A	8	控制标志		
KONZFS	A	1	控制方式		
XIYZBH	A	16	信用证编号		
XIYZXZ	A	1	信用证性质		
BAOZFS	A	1	保证方式		
JIOBFS	A	1	交保证金方式		
JIAODQ	N	交单期		
FUK1FS	A	1	付款方式		
FENPZY	A	1	分批装运		
ZHUANY	A	1	转运		
FASOFS	A	1	发送方式		
FEYCDR	A	1	费用承担人		
GLKZBZ	A	1	是否有功能控制		
FUKUQX	N	付款期限		
DHKTBZ	A	1	电话银行开通标志		
ZZKTBZ	A	1	自助终端开通标志		
WYKTBZ	A	1	网上银行开通标志		
GMKTBZ	A	1	柜面开通标志		
JDKTBZ	A	1	券商电话委托开通标志		
JWKTBZ	A	1	券商网上委托开通标志		
PSKTBZ	A	1	自动配售开通标志		
YJKTBZ	A	1	自动邮寄对帐单开通标志		
CJIOBH	A	10	成交编号		
MAIMLB	A	1	买卖类别		
JAOYZT	A	1	交易状态		
TGXIWH	A	8	托管席位号		
WEITBH	A	10	委托编号		
ZUIXJG	R	REFFLD(JIOYJE)	最新价		
ZUIGJG	R	REFFLD(JIOYJE)	最高价		
ZUIDJG	R	REFFLD(JIOYJE)	最低价		
ZSPAJG	R	REFFLD(JIOYJE)	昨收盘价		
JKPAJG	R	REFFLD(JIOYJE)	今开盘价		
WTUOZT	A	1	委托状态
SUSDDM	A	3	所属地区代码
HEMDBZ	A	1	黑名单标志
DANZYE	P	15	2	宕账余额
HUOWMS	A	70	货物描述
YITJDJ	A	70	受益人应提交单据
QITATK	A	70	其他条款
BAOZWJ	A	70	开证行保证文句
SFYDZD	A	1	是否产生对帐单
FDZHBZ	A	1	分段帐户标志
WJZHXZ	A	4	外管局账户性质
QIYNBZ	A	1	启用标志
BIZHZH	A	4	币种组合
WHYWBH	A	13	外汇业务编号
KADEMS	A	40	卡的描述
ZHQ1DM	A	25	债券代码1
ZHQ2DM	R	REFFLD(ZHQ1DM)	债券代码2
ZHQUDM	R	REFFLD(ZHQ1DM)	债券代码
ZQJIXI	A	1	债券计息方式
LLIBOR	A	4	浮动利率Libor
FAKASL	N	发卡数量
FAKAWJ	A	32	发卡文件
LNKAWJ	A	32	领卡文件
BWQXZH	A	20	表外欠息帐号(非应计,本金逾期90天)
BWKZZH	A	20	表外欠息帐号(利息逾期90天)
BWQ2LX	P	16	8	表外欠息2利息
YWDQKZ	A	1	有无地区控制
YPOSKZ	A	1	有无POS控制
SIFYZP	A	1	是否有照片
JINWSR	R	REFFLD(ZHHUYE)	境外收入
JINNSR	R	REFFLD(ZHHUYE)	境内收入
HUICJW	R	REFFLD(ZHHUYE)	汇出境外
JINNHC	R	REFFLD(ZHHUYE)	境内划出
JIEHUI	R	REFFLD(ZHHUYE)	结汇金额
ZEMYJE	R	REFFLD(ZHHUYE)	折美元金额
ZIJIYT	A	1	资金用途
SHEBHM	A	22	国际收支申报号码
RHJGDM	A	20	银行机构代码（人行）
XIAHJE	R	REFFLD(JIOYJE)	现汇金额
QITAJE	R	REFFLD(JIOYJE)	其它金额
SHPJBH	A	30	审批件编号
GJSZBM	A	5	国际收支编码
YIGYDM	A	24	应用代码
TNBREN	A	60	填报人
SHNBRQ	R	REFFLD(RIQIII)	申报日期
SHEWBZ	A	1	涉外标志
RHDQDM	A	6	地区代码（人行）
JRJGDM	A	4	金融机构代码（人行）
JIGSXM	A	2	金融机构顺序号（人行）
XIOFBZ	A	1	消费标志						
QUEKBZ	A	1	取现标志
CNKNBZ	A	1	存款标志
YNZTBZ	A	1	银证通标志
DAIFBZ	A	1	代发标志
DAIKBZ	A	1	代扣标志
JJMMBZ	A	1	基金买卖标志
WHMMBZ	A	1	外汇买卖标志
LCYWBZ	A	1	理财业务标志
YIKTBZ	A	1	一卡通标志
ZZHGBZ	A	1	转帐标志
JYMMBZ	A	1	检验密码标志
XGMMBZ	A	1	修改密码标志
SDMMBZ	A	1	锁定密码标志
YXXHBZ	A	1	允许销户标志
SOKABZ	A	1	锁卡标志
KUAHBZ	A	1	跨行标志
KDQUBZ	A	1	跨地区标志
HZKMCC	A	40	合作卡名称
SXFLZL	A	2	手续费率种类
JJKBIN	A	8	借记卡BIN
DJKBIN	R	REFFLD(JJKBIN)	贷记卡BIN
LKABIN	R	REFFLD(JJKBIN)	老卡BIN
SHFOSH	A	1	是否省级行标志
ZHZHLX	A	4	约定转帐类型
BWYWLX	A	1	报文业务类型
HANGLB	A	1	行类别
GXYZZT	A	1	信用证状态
FENLSY	A	1	分理处适用	
WXZTBZ	A	1	尾箱状态标志
XBWXBZ	A	1	现金/表外尾箱标志
KHZHJB	A	2	客户综合评估级别
WGXTYW	A	20	外挂系统开通业务集
GUOBDM	A	3	国别代码
QYWGDM	A	6	企业外管代码
WGKTYW	A	20	外挂系统开通业务集
SQZDFS	A	2	收取帐单方式
JYQSSJ	A	8	交易起始时间
ZHIYFS	A	1	质押方式
DIYWZL	A	1	抵押物种类
SHOFZQ	A	1	收费周期
FUFEIF	A	1	付费方
SHOQBZ	A	1	收讫标志
YOUHB1	P	8	5	手续费优惠比例	
ZHYOD2	A	22	摘要代码2
KHDBBH	A	12	客户担保编号
SFPLFK	A	1	是否批量发卡
BZJSXH	A	1	保证金到期扣款顺序
XLKABZ	A	1	新老卡标志
TJRZFS	A	1	入帐方式
YZKHZT	A	1	银证通客户状态
YZKHLB	A	1	银证通客户类别
TJJXTS	N	计息天数
KHBZGZ	A	1	卡号编制规则
WAIGDM	A	12	外管代码
FKJGDM	A	2	发卡机构代码
JGYXJB	A	1	机构营销级别
YNGXSJ	A	4	营销上级
ZHXLZT	A	10	帐户序列状态
ZHGWSJ	A	4	修改后柜员机构上级
FBDBIC	R	REFFLD(BICCOD)	发报行的代理行BIC
SBDBIC	R	REFFLD(BICCOD)	收报行的代理行BIC
DIWYNR	R	REFFLD(DIAWNR)	电文域内容
SLBHAO	A	18	受理编号
QISHSJ	R	REFFLD(SHJIAN)	起始时间
ZZHISJ	R	REFFLD(SHJIAN)	终止时间
KFJJDM	A	6	基金代码
JEDHBZ	A	1	巨额赎回处理标志
JJYWLS	A	24	基金系统业务流水
JJCDLS	A	24	基金撤单流水号
FNHNFS	A	1	分红方式
JISHFS	A	1	寄送方式
TADAIM	A	2	TA代码
KFJJMC	A	20	基金名称
KFJJGL	A	20	基金管理人
KFJJZC	A	20	基金登记注册人
KFJJZT	A	10	当日基金状态
KFJJGG	A	250	基金最新公告
BANGZY	A	40	公司主页
GRJGBZ	A	1	个人/机构标志
KFJJXB	A	1	基金个人性别
JJKFZT	A	1	基金帐户状态
ZHJNMC	A	20	基金证件类型名称
DLZJMC	A	20	基金代理证件类型名称
FUKUXL	A	70	付款线路
BUFDDJ	A	70	不符点登记
JJJYZT	A	1	基金交易状态
SQJZXX	R	REFFLD(JIOYJE)	申请净值下限
SQJZSX	R	REFFLD(JIOYJE)	申请净值上限
BUFDCL	A	1	不符点处理
FUKURQ	A	8	付款日期
DAOQBH	A	8	到期编号
SWIFLX	A	4	SWIFT帐号类型
ZHUHCP	R	REFFLD(FKTJZH)	帐户行CP号
KFJJXL	A	2	学历
JJZYDM	A	2	职业代码
ZHAOX2	A	7	客帐号序号		
KABINH	A	8	卡BIN号
GSXEYE	P	15	2	挂失小额余额
SWILX1	R	REFFLD(SWIFLX)	SWIFT帐号类型
SWILX2	R	REFFLD(SWIFLX)	SWIFT帐号类型
SWILX3	R	REFFLD(SWIFLX)	SWIFT帐号类型
BIAOSH	A	8	标识号
GUOBJM	A	2	国别简码
QCJEEE	P	15	2	圈存金额
DCHBIC	R	REFFLD(BICCOD)	调出行BIC号码
DCHGZH	A	20	调出行帐号
DRHGZH	A	20	调入行帐号
JIDHLB	A	1	交单行类别
ZIDZWM	A	40	字段中文名
CCYUSJ	A	40	差错源数据
CCMBSJ	A	40	差错目标数据
CCLBIE	A	2	差错类别
DJFSBZ	A	1	登记方式标志
JIUZHH	A	24	旧账号
SXFYLY	A	1	手续费来源
SXFBZH	A	2	手续费币种
QANTRQ	R	REFFLD(RIQIII)	前台日期
TZYHTS	N	透支优惠天数
QTJEEE	P	15	2	圈提金额
CHUBFS	A	1	出报方式
LAOKAH	R	REFFLD(KAHAOO)	老卡号
XINKAH	R	REFFLD(KAHAOO)	新卡号
DMZHI1	R	REFFLD(JIOYJE)	债券面值1
DMZHI2	R	REFFLD(JIOYJE)	债券面值2
DMZHI3	R	REFFLD(JIOYJE)	债券面值3
DMZHI4	R	REFFLD(JIOYJE)	债券面值4
DMZHI5	R	REFFLD(JIOYJE)	债券面值5
ZAQJC1	R	REFFLD(ZHAQJC)	债券简称1
ZAQJC2	R	REFFLD(ZHAQJC)	债券简称2
ZAQJC3	R	REFFLD(ZHAQJC)	债券简称3
ZAQJC4	R	REFFLD(ZHAQJC)	债券简称4
ZAQJC5	R	REFFLD(ZHAQJC)	债券简称5
ZHQ3DM	R	REFFLD(ZHQ1DM)	债券代码3
ZHQ4DM	R	REFFLD(ZHQ1DM)	债券代码4
ZHQ5DM	R	REFFLD(ZHQ1DM)	债券代码5
ZAQSL1	R	REFFLD(JIOYJE)	债券数量1
ZAQSL2	R	REFFLD(JIOYJE)	债券数量2
ZAQSL3	R	REFFLD(JIOYJE)	债券数量3
ZAQSL4	R	REFFLD(JIOYJE)	债券数量4
ZAQSL5	R	REFFLD(JIOYJE)	债券数量5
ZHQZL1	R	REFFLD(ZHQNZL)	债券种类1
ZHQZL2	R	REFFLD(ZHQNZL)	债券种类2
ZHQZL3	R	REFFLD(ZHQNZL)	债券种类3
ZHQZL4	R	REFFLD(ZHQNZL)	债券种类4
ZHQZL5	R	REFFLD(ZHQNZL)	债券种类5
TGHBIC	R	REFFLD(BICCOD)	托管行BIC
ZQMZZE	R	REFFLD(JIOYJE)	债券面值总额
HKBZZZ	A	1	换卡标志
SFLFFK	A	10	是否能发附卡
ZJDEYE	P	15	2	主机小额余额
ZJXEYE	P	15	2	主机大额余额
GOUDGY	R	REFFLD(GUIYDH)	勾对柜员
BAOWZL	A	1	报文种类
MAIMLX	A	1	买卖类型
GPLEIX	A	1	挂盘类型
CDLEIX	A	1	撤单类型
YOUHLX	A	1	优惠类型
WHJYLB	A	1	外汇宝交易类别
WHCXLX	A	1	查询类型
DKFXXS	A	8	贷款风险系数
YWGLBH	A	1	贷款业务归类编号
YQLYWH	A	4	逾期贷款利息收入科目业务代号
BWFYWH	A	4	表外应收利息科目业务代号2(非应计,90天以上)
BWKZWH	A	4	表外应收利息科目业务代号(扩展用)
BWBYWH	A	4	表外本金业务代号
BWYYWH	A	4	表外逾期本金业务代号
WEITLX	A	1	委托类型
TOUZLX	P	15	2	透支利息
BWYWGN	A	8	报文业务功能
CPXGBZ	A	1	传票相关标志
MQJIAG	P	15	5	每券价格
ZQTQZZ	A	1	债券投资是否有提前终止
KHJLMC	A	8	客户经理
DQZQZH	R	REFFLD(ZHANGH)	短期债权性投资帐号
JYZQZH	R	REFFLD(ZHANGH)	交易性证券帐号
JIXIBZ	A	1	计息标志	
YWZLBH	A	4	业务种类编号
DANWBH	A	8	单位编号
SHOFBZ	A	1	收付标志
YEWUFW	A	1	业务范围
YWHDZT	A	1	业务活动状态
SFSQFS	A	2	手续费收取方式
KHJLHM	A	20	客户经理号码
KHJLBM	A	20	客户经理部门
KHJLXM	A	20	客户经理姓名
XYSHBH	A	20	协议书编号
DANWMC	A	40	单位名称
DAXEBZ	A	1	大小额标志
SKHBIC	R	REFFLD(BICCOD)	收款行BIC
TZJYZL	A	1	投资业务交易种类
SHOKZS	A	70	收款指示
TONZJE	R	REFFLD(JIOYJE)	通知金额
YIFUBZ	A	1	议付标志
YIFULV	R	REFFLD(LILVLL)	议付利率
YIFULX	R	REFFLD(ZHHUYE)	议付利息
YIFUJE	R	REFFLD(JIOYJE)	议付金额
LJYFJE	R	REFFLD(JIOYJE)	累积议付金额
SHTUJE	R	REFFLD(JIOYJE)	收妥金额
WAIKJE	R	REFFLD(JIOYJE)	外扣金额
SJFKJE	R	REFFLD(JIOYJE)	实际放款金额
XIYZYE	R	REFFLD(JIOYJE)	信用证余额
DADAJE	R	REFFLD(JIOYJE)	到单金额
QUREJE	R	REFFLD(JIOYJE)	确认金额
FUKUJE	R	REFFLD(JIOYJE)	付款金额
ZAXINR	A	70	杂项内容
KAZHHH	R	REFFLD(LIANHH)	开证行行号
KZHBIC	R	REFFLD(BICCOD)	开证行BIC
KAZHHM	R	REFFLD(HNGMNG)	开证行行名
TOZHHH	R	REFFLD(LIANHH)	通知行行号
TZHBIC	R	REFFLD(BICCOD)	通知行BIC
TOZHHM	R	REFFLD(HNGMNG)	通知行行名
SOYHHH	R	REFFLD(LIANHH)	受益行行号
SOYHHM	R	REFFLD(HNGMNG)	受益行行名
YIFHHH	R	REFFLD(LIANHH)	议付行行号
YFHBIC	R	REFFLD(BICCOD)	议付行BIC
YIFHHM	R	REFFLD(HNGMNG)	议付行行名
TOZHLB	A	1	通知行类别
SHYHLB	A	1	受益行类别
YIFHLB	A	1	议付行类别
TSCLBZ	A	1	托收处理标志
ZJYWBH	A	15	中间业务编号
XJHUBZ	A	1	旧户标志
YZMMBZ	A	1	银证通买卖标志
TNGZZT	A	1	通知状态
FASCSH	P	2	要求发送次数
SCQLEX	A	1	生存期类型
XZHZHI	P	5	生存期限制值
FASSHD	A	10	发送时段要求
FANWEI	A	1	范围
DFDKBZ	A	1	代发代扣标志
WJKRFS	A	1	文件拷入方式
SKQRBZ	A	1	收款确认标志
DJXLHM	A	4	冻结序列号
JTYWDH	A	4	计提应收利息业务代号
CHULFS	A	1	处理方式
LJDDJE	R	REFFLD(JIOYJE)	累计到单金额
LJQRJE	R	REFFLD(JIOYJE)	累计确认金额
LJFKJE	R	REFFLD(JIOYJE)	累计付款金额
WTSKJE	R	REFFLD(JIOYJE)	委托收款金额
LJWSJE	R	REFFLD(JIOYJE)	累计委托收款金额
SFYJKF	A	1	是否已经扣费
SKZHLX	A	1	收款人账号类型
HUAKLX	A	1	系统内划款类型
BHZGBS	A	2	本行职工表识
SHDHBZ	A	3	收单行标识
DQYHDM	A	4	收单行地区银行代码
SHDHDM	A	4	收单行地区代码
SHDHMC	A	20	收单行地区名称
SHESDM	A	2	商户地址-省市代码
YHMODM	A	10	银行MODEM
ZXMODM	A	10	中心MODEM
YOUXBZ	A	1	有效标志
SHLBMS	A	40	商户类别描述
SHHUBH	A	15	商户编号
LJFSBZ	A	1	商户连接方式标识代码
SHHUMC	A	30	商户名称
SHKHDM	A	9	商户开户行代码
SHDYDM	A	8	商户地域代码
SHHUDZ	A	30	商户地址
SHULXR	A	8	商户联系人
SHSFXS	A	1	商户收费形式
SFJEBL	P	7	2	商户收费金额/比率
SHMODM	A	10	商户MODEM
POSZBH	A	12	POS终端编号
POSZZT	A	1	POS终端状态
ZDSCBZ	A	1	POS终端上传标志
ZDFKBZ	A	1	POS终端发卡标志
BAOGDH	A	20	报关单号
FUQIFS	A	1	付清方式
XFDANH	A	20	税费单号
JAOYAN	A	2	校验
HGJYZT	A	1	海关交易状态
YEWULX	A	1	业务类型
TOXUZT	A	2	通讯状态
YBWLSH	R	REFFLD(BAOWLS)	原报文流水号
FABORQ	R	REFFLD(RIQIII)	发报日期
KHLLLX	A	2	模拟利率类型
KHJXLX	A	2	模拟利率减项类型
ZJCHAO	N	子进程号
DXSFFS	A	2	短信收费方式
DXDWSF	P	4	2	短信单位收费
BJFYHH	A	21	被记费用户号
WWKTYW	A	50	外围系统开通集	
WWXTYW	A	50	外围系统开通集
SXSQBZ	A	1	手续费收取标志
FSQSSJ	R	REFFLD(TNGZSJ)	发送起始时间
FSJSSJ	R	REFFLD(TNGZSJ)	发送结束时间
WHGMLX	A	1	柜面外汇买卖类型
DADIBZ	A	1	是否允许转逾期标志	
DILYBH	A	20	垫款来源编号
MCXZBZ	A	1	卖出现转标志
WTCLBZ	A	1	委托处理标志
SHURFS	A	1	输入方式
PIZUBS	A	1	批注标识
CHLIJG	A	256	处理经过
YKLXBH	A	10	源卡类型编号
YKDQHH	A	2	源卡地区号
MKLXBH	A	10	目标卡类型编号
MBKDQH	A	2	目标卡地区号
FHBZZZ	A	1	互换标志
CHULLX	A	1	处理类型
BHLEIX	A	1	编号类型
FDYXRQ	A	1	浮动有效日期
FDNGFS	A	1	浮动金额方式
KHCPBH	A	10	考核产品编号
TOUZZH	A	20	透支帐号
XKAYYY	A	1	销卡原因
WBJHFS	A	1	外币交换方式
MIYJBH	A	12	密押机编码
GONNDM	A	2	功能代码
JITIJE	P	15	2	计提金额
ZHBWBZ	A	2	本金利息转90天标志
CHAXDM	A	2	查询代码
ZHIJLX	A	1	资金类型
KHYWGL	A	2	考核业务归类
DANZLX	A	1	宕账类型
TIOZYY	A	1	调整原因
ZHOWWZ	A	2	中文文字
SIJIOM	A	4	四角码
KHRJYE	R	REFFLD(ZHHUYE)	日均余额
WENJLX	A	1	文件类型
QSXFXH	N	起始消费序号
JSXFXH	N	结束消费序号
JIEYJE	P	15	2	结余金额
XUHAOS	N	序号数
JEYXHS	N	结余序号数
DANZZT	A	1	宕账状态
CHULJG	A	1	处理结果
ZJDZFS	A	1	增加宕帐方式
JSDZFS	A	1	减少宕帐方式
JTZHBZ	A	1	集团帐户标志
KFZZDM	A	6	基金代码
CWFXLX	R	REFFLD(JIOYJE)	本次偿还表外复息利息
CWFXJE	R	REFFLD(JIOYJE)	本次偿还表外复息	
DIKALX	A	1	垫款类型
FXLJLX	P	15	2	表外复息
BWFXLX	P	16	8	表外复息利息
BWFXZH	A	20	表外复息帐号
FXSCRQ	A	8	表外复息上次计息日
BWFXJS	P	20	2	积数
FXYJLX	P	13	2	表外复息应加减利息
BWFXLL	P	9	7	利率
BWFXJE	P	15	2	表外复息
FXSFJE	P	13	2	收方发生额
FXHFJE	P	13	2	付方发生额
ZHYFJE	P	15	2	帐户1还表外复息金额
ZHEFJE	P	13	2	帐户2还表外复息金额
ZHYHJE	P	13	2	帐户1还表外复息的利息金额
ZHEHJE	P	13	2	帐户2还表外复息的利息金额
PIJULY	A	1	票据来源
NFFAFK	A	1	是否能发A类附卡
NFFBFK	A	1	是否能发B类附卡
NFFCFK	A	1	是否能发C类附卡
NFFAZK	A	1	是否能发主卡
BAOIDN	A	10	报文标识号
ZYDKLX	A	1	质押贷款类型
YZLEIX	A	1	银证转帐类型
DQHZZQ	A	1	定期划转周期
GLYDLM	A	20	管理员登录名	
GLDLMM	A	20	登录密码	
GULYXM	A	10	管理员姓名
GYSZCN	A	4	管理员数字证书CN
YWZGXM	A	10	业务主管姓名
YWZGCN	A	4	业务主管数字证书CN
WYZHXZ	A	1	网银账户性质
GJJGBZ	A	1	挂接解挂处理标志
QIYEZT	A	1	企业状态
WYGLXZ	A	50	网银功能选择
QIXNBZ	A	1	期限标志
KHZLJE	R	REFFLD(ZHHUYE)	增量金额	
KHTXJE	R	REFFLD(ZHHUYE)	贴息金额	
KHMNLR	R	REFFLD(ZHHUYE)	模拟利润金额
BAOBZL	A	1	报表种类
JDMSSS	A	8	简单描述
ZHHMDD	A	1	状户黑名单状态
GEGSBZ	A	1	高额挂失标志
GSBZZZ	A	1	挂失标志
FBDJBZ	A	1	封闭冻结标志
DJBCBZ	A	1	冻结(只进不出)标志
ZFBZZZ	A	1	止付标志
SFKZBZ	A	1	是否控制标志
WHCJLX	A	1	成交类型
YOUXQY	A	4	有效期月
KHPMFS	A	1	考核排名方式
CAOZFS	A	1	操作方式
BAOWRQ	A	8	报文日期
YQXIAN	A	6	原期限
TJJYXH	A	4	脱机交易序号
TJJYLX	A	2	脱机交易类型
DAEBSS	N	大额笔数
XAEBSS	N	小额笔数
YJIZLL	R	REFFLD(LILVLL)	原基准利率		
CID3XX	A	107	三磁道
ZLHUBZ	A	1	自来户标志
DADAXH	N	到单序号
SFJBGY	R	REFFLD(GUIYDH)	收/付款经办柜员
SFFHGY	R	REFFLD(GUIYDH)	收/付款复核柜员
SFJBLS	R	REFFLD(GUIYLS)	收/付款经办柜员流水号
SFFHLS	R	REFFLD(GUIYLS)	收/付款复核柜员流水号
ZHUXBZ	A	1	注销标志
KHCKZE	R	REFFLD(ZHHUYE)	存款总额	
KHDKZE	R	REFFLD(ZHHUYE)	贷款总额	
KHCDBL	R	REFFLD(BILIII)	考核机构存贷比	
LZCLFS	A	1	来帐处理方式
XLMMBZ	A	1	新老密码标志
JZZLSH	A	10	记帐子流水号
MYLSHO	A	18	贸易主流水号
TZLEIX	A	1	通知类型	
BAOLXS	A	1	保理形式	
YZZZBZ	A	1	银证转帐标志
MIYBBH	N	密钥版本号
BAWMAC	A	16	报文MAC
PINLBZ	A	1	批量标志	
SHOUQH	A	20	授权号	
DSYHB2	A	30	第三方用户编号	
DSYHLX	A	10	第三方产品类型	
CHUZBZ	A	1	冲正标志	
ZHANGT	A	1	状态	
SHLHDM	A	4	受理行代码
CFTYXZ	A	1	存放同业性质		
DRCZJE	R	REFFLD(ZHHUYE)	当日出帐金额	
DRRZJE	R	REFFLD(ZHHUYE)	当日入帐金额	
DBSSJE	R	REFFLD(ZHHUYE)	调拨试算金额	
CJSSJE	R	REFFLD(ZHHUYE)	拆借试算金额	
SSYHYE	R	REFFLD(ZHHUYE)	试算以后余额	
BLYWZL	A	1	保理业务种类
LJSHXF	R	REFFLD(JIOYJE)	累计手续费金额	
LJYDNF	R	REFFLD(JIOYJE)	累计邮电费金额	
DANJUU	A	70	单据	
LXGYLS	A	8	老系统柜员流水
MESGID	A	3	消息ID号
FAXHDM	A	4	发行行代码
ZHHZYE	R	REFFLD(ZHHUYE)	帐户总余额
ZHHYXE	R	REFFLD(ZHHUYE)	有效余额
LXZJHM	A	30	老系统证件号码
SFFSFS	A	1	手续费收取方式	
SHOUKR	A	150	收款人
FUYANN	A	220	附言
ZHAGHH	A	200	受益人开户行
FABDLH	A	200	发报行的代理行
SOBDLH	A	200	收报行的代理行
ZHOGJH	A	200	中间行
HUIKRR	A	150	汇款人
YTJIEJ	R	REFFLD(JIEJUH)	银团主办行借据号
CFSHBH	R	REFFLD(YEWUBH)	查询查复书编号
XGCFBH	R	REFFLD(YEWUBH)	相关查询查复书编号
JILUBZ	A	1	记录标志
FNXIJE	R		REFFLD(JIOYJE)	风险金额
YZJHDM	A	8	原证监会代码
XZJHDM	A	8	新证监会代码
GNLIS0	R	REFFLD(GNLISJ)
GNLIS1	R	REFFLD(GNLISJ)	
GNLIS2	R	REFFLD(GNLISJ)
KHCLJE	R	REFFLD(ZHHUYE)	存量金额	
THYWBH	R	REFFLD(YEWUBH)	退汇业务编号
DANJZL	A	70	单据种类
DANJFS	N	单据份数	
DZHIBJ	R	REFFLD(JIOYJE)	呆滞本金
DAIZBJ	R	REFFLD(JIOYJE)	呆帐本金
TUSHLX	A	1	托收类型
DXKTYW	A	50	短信开通集
DJJDZT	A	1	冻结解冻状态
QIXITJ	A	1	起息途径	
DAOQTJ	A	1	到期途径	
LEJILX	P	19	6	累计利息
LIIXII	P	19	6	利息
YANGSM	A	4	样式名
DZXHHH	A	20	宕帐序号
HZI10A	A	10	打印汉字10A
HZI10B	A	10	打印汉字10B
HZI10C	A	10	打印汉字10C
HZI10D	A	10	打印汉字10D
HZI10E	A	10	打印汉字10E
HZI10F	A	10	打印汉字10F
HZI10G	A	10	打印汉字10G
HZI10H	A	10	打印汉字10H
HZI10I	A	10	打印汉字10I
HZI10J	A	10	打印汉字10J
HZI08A	A	8	打印汉字08A
HZI08B	A	8	打印汉字08B
HZI08C	A	8	打印汉字08C
HZI08D	A	8	打印汉字08D
HZI08E	A	8	打印汉字08E
HZI08F	A	8	打印汉字08F
HZI08G	A	8	打印汉字08G
HZI08H	A	8	打印汉字08H
HZI06A	A	6	打印汉字06A
HZI06B	A	6	打印汉字06B
HZI06C	A	6	打印汉字06C
HZI06D	A	6	打印汉字06D
KUAXLY	A	1	款项来源
KUAXQX	A	1	款项去项
BAWLS2	A	16	相关报文流水		
KHTZLX	A	2	考核调整系数类型	
RIIII1	R	REFFLD(RIIIII)	起始日	
RIIII2	R	REFFLD(RIIIII)	到期日	
YUEEE1	R	REFFLD(YUEEEE)	起始月	
YUEEE2	R	REFFLD(YUEEEE)	到期月	
NIANN1	R	REFFLD(NIANNN)	起始年	
NIANN2	R	REFFLD(NIANNN)	到期年
YFJBGY	R	REFFLD(GUIYDH)	议付经办柜员	
YFFHGY	R	REFFLD(GUIYDH)	议付复核柜员	
YFJBLS	R	REFFLD(GUIYLS)	议付经办柜员流水号	
YFFHLS	R	REFFLD(GUIYLS)	议付复核柜员流水号	
KAZHDZ	R	REFFLD(DIZHII)	开证行地址	
FKZHLX	A	1	付款账号类型
FQHHAO	A	12	发起行行号
SBHHAO	A	12	收报行行号
YYEDZH	A	20	已用额度帐号
ZZDWZL	A	1	自制电文种类
YTDKZL	A	1	银团贷款种类
TAGBIS	A	5	TAG表示
SFCFCP	R	REFFLD(SHFOBZ)	是否拆分传票标志	
CFCPJE	R	REFFLD(JIOYJE)	传票拆分金额	
CBZPRN	A	1	钞汇标志
CPZ1XH	R	REFFLD(CPZNXH)	传票组内序号	
LXTZQX	P	7	连续透支期限
LXTZDQ	A	8	连续透支到期日
ZHYQQX	P	7	转逾期期限
LTQXRQ	A	8	连续透支发生日
LTDQRQ	A	8	连续透支到期日
YCJTJE	P	15	2	已冲计提金额
BWQXLX	P	16	8	表外欠息利息
KHYWMC	R	REFFLD(KEHZWM)	考核业务种类名称
ZJCYBZ	A	1	直接参与现代支付标志
THJYXH	A	6	退汇支付交易序号
SHKHLX	A	1	收报行类型
ZJCYHH	A	12	直接参与行号
QISHHH	A	12	清算行行号
HANBDM	A	3	行别代码
FBZXDM	A	4	发报中心代码
JIEDDM	A	5	节点代码
ZFXTZT	A	2	支付系统状态
QSZHZH	A	16	清算账户账号
BAWELX	A	6	现代支付报文类型
WANLBZ	A	1	往来标志
PIZHBZ	A	1	平帐标志
DAXIBZ	A	1	大小额标志
QIZHBH	A	3	前置机编号
YEWUZL	A	2	现代支付业务种类
JIGULB	A	2	现代支付机构类别
QSZHZT	A	1	清算账户状态
ZHUANT	A	1	状态
SSRHDM	A	12	所属人行代码
HKYWLX	A	1	业务种类
ZHYYJG	R	REFFLD(YNGYJG)	帐户营业机构
SKZBIC	R	REFFLD(BICCOD)	收款行帐户行BIC
QXRZBS	R	REFFLD(BISHUU)	起息入帐笔数	
QXSBBS	R	REFFLD(BISHUU)	起息失败笔数	
DQRZBS	R	REFFLD(BISHUU)	到期入帐笔数	
DQSBBS	R	REFFLD(BISHUU)	到期失败笔数	
CANYBZ	A	1	参与标志
BOKXHH	R	REFFLD(KDETXH)	拨款序号
JIANCH	A	20	简称
DIHDIG	A	30	电话/电挂
DIAZYJ	A	30	电子邮件地址
SHIXRQ	A	8	失效日期
FKFBSS	A	20	发卡方标识
CMTCOD	A	3	CMT编号
CMTNAM	A	80	CMT名称
CMTIMF	A	1	进报标志
CMTOMF	A	1	出报标志
CMHVPS	A	1	HVPS标志
CMBEPS	A	1	BEPS标志
CMSAPS	A	1	SAPS标志
CMPMIS	A	1	PMIS标志
CMCKAC	A	1	参与对帐
TAGSEQ	N	TAG	序号
TAGMOF	A	1	TAG强制	
TAGCOD	A	3	TAG标识	
TAGNAM	A	80	TAG名称
TAGREP	A	3	TAG重复
TAGFMT	A	80	TAG格式
TAGDSC	A	256	TAG描述
STGCNT	N	TAG	子域个数
STGTYP	A	256	TAG子域类型
STGLEN	A	256	TAG子域长度
STGPRE	A	256	TAG子域精度
STGBAS	A	256	TAG子域基数
STGIFM	A	256	TAG子域输入格式
STGOFM	A	256	TAG子域输出格式
TAGVAL	A	80	TAG取值
TAGLIN	N	TAG	行号
TAGCTN	A	256	TAG内容
MSGSNO	A	20	报文序列号
MSGBNO	N	报文业务块号	
MSGFNM	A	256	报文文件名
MSGIOF	A	1	进出报标志
MSGLEN	P	6	报文长度
MSGUSE	A	1	报文用途
MSGTFF	A	1	来往标记
MSGBUS	A	1	业务类型
MSGBST	A	3	业务状态码
MSGIDN	A	8	报文标识号
MSGRNO	A	20	报文参考号
MSGSDT	Q	报文发送日期
MSGSTM	P	6	报文发送时间
MSGRDT	Q	报文接收日期
MSGRTM	P	6	报文接收时间
WRKDAT	Q	CNAPS工作日期
IDRQNT	P	10	来帐借记笔数
ICRQNT	P	10	来帐贷方笔数
ODRQNT	P	10	往帐借方笔数
OCRQNT	P	10	往帐贷方笔数		
PAYPRI	A	1	支付优先级		
PRESRV	A	16	预留字段	
XEYEBZ	A	1	小额余额标志
BYJBZZ	A	1	备用金余额标志
DEYEBZ	A	1	大额余额标志
SFYYHK	A	1	是否有预换卡
PPMRJA	R	REFFLD(PAIJIA)	平盘买入价	
PPMCJA	R	REFFLD(PAIJIA)	平盘卖出价	
LJEDBZ	A	1	联机透支额度标志
TJEDBZ	A	1	脱机透支额度标志
YASHJW	A	20	系统外全国压数机编号
YASHJN	A	20	系统内全国压数机编号
YASHJS	A	20	三省一市压数机编号
YASHJX	A	20	市辖汇票压数机编号
EZAKEY	A	32	MACKEY
MACKCK	A	16	MACKCK	
EZPKEY	A	32	PINKEY
PINKCK	A	16	PINKCK	
DIABGH	A	5	电报挂号
DAILHH	R	REFFLD(LIANHH)	代理行行号
KHBILI	P	5	2	考核比例
DAYXX1	A	100	打印信息
DAYXX2	A	100	打印信息
DAYXX3	A	100	打印信息
DAYXX4	A	100	打印信息
DAYXX5	A	100	打印信息
DAYXX6	A	100	打印信息
DAYXX7	A	100	打印信息
DAYXX8	A	100	打印信息
DAYXX9	A	100	打印信息
KHJSLX	R	REFFLD(KHYWLX)	考核利润计算业务类型
KHTJLX	R	REFFLD(KHYWLX)	考核统计业务类型
TXFXFS	A	1	贴现付息方式	
QCYEEE	R	REFFLD(DEQCYE)	圈存余额
YNJIEJ	R	REFFLD(JIEJUH)	原贴现借据号	
ZHADLX	A	1	帐单形式
JAIJIZ	A	1	介质
LXJYMM	A	16	新老通兑密码
YSQJEE	P	15	2	预授权金额
LCZQYE	P	15	2	零存整取余额
JYCXYE	P	15	2	教育储蓄余额
CBQXYE	P	15	2	存本取息余额
DQYDYE	P	15	2	定期约定余额
YUNSFS	A	62	运输方式	
JIODQ1	R	REFFLD(RIQIII)	交单期	
MACJGH	A	4	MAC机构号	
PINZHZ	A	16	PIN种子	
ZHYODJ	A	1	重要等级
KEHYWM	A	160	客户英文名
DISFCF	A	200	第三方偿付行
SHOUYH	A	200	受益银行
ZUICHK	A	200	最初汇款行
KTGMBZ	A	1	开通国贸标志
CMTFNM	A	256	CMT文件名
QCQTBZ	A	1	圈存圈提标志	
BKFSJE	R	REFFLD(JIOYJE)	拨款发生额
GMZSBZ	A	1	国贸直属支行标志
QIXILY	A	1	欠息来源
QXCZBZ	A	1	欠息曾转表外标志
YQLXJE	P	13	2	逾期利息收入总金额
BHLXJE	R	REFFLD(JIOYJE)	本行利息收入金额
BHYSJE	R	REFFLD(JIOYJE)	本行利息收入金额
BHLXRQ	A	8	本行利息产生日期
RMBJEE	P	17	2	本币金额
RMBJE1	R	REFFLD(RMBJEE)	本币金额1
RMBJE2	R	REFFLD(RMBJEE)	本币金额2
RMBJE3	R	REFFLD(RMBJEE)	本币金额3
RMBJE4	R	REFFLD(RMBJEE)	本币金额4
RMBJE5	R	REFFLD(RMBJEE)	本币金额5
SUIDLX	A	1	税单类型
CZCLXI	P	15	2	冲正常利息收入欠息
KHRYLX	A	1	考核人员类型
ZHJNHO	A	19	证件号
YINGWM	A	40	拼音名/英文名
SHMGXX	A	32	说明信息
ZHSDN1	A	65	证书DN1
ZHSDN2	A	65	证书DN2
ZHSDN3	A	65	证书DN3
ZHSDN4	A	65	证书DN4
CANKHO	A	8	参考号
ZHSZHS	P	4	证书张数
SHUNXU	P	8	顺序号
ZHJNLX	A	1	证件类型
ZHSHUL	A	1	证书类型
TUIPLX	A	1	退票类型
BOWLX2	A	5	报文类型2
BOWLS2	A	16	报文流水2
COPJYZ	A	1	COP交易标志
WOPJYZ	A	1	WOP交易标志
SOPJYZ	A	1	SOP交易标志
DZNBZH	A	20	宕帐调整对方内部帐号
KHJGLS	R	REFFLD(KHYXJG)	营销机构
JIFUBZ	A	1	即付标志
SMSGLX	A	3	SWIFT报文类型	
SMSGFW	A	1	SWIFT报文打印范围
SMSGMC	A	60	SWIFT报文文件名称
SMSGFX	A	1	SWIFT报文方向	
JFCHBZ	A	1	借方钞汇标志	
DFCHBZ	A	1	贷方钞汇标志	
CPBH01	A	4	产品编号1
CPBH02	A	4	产品编号2
CPBH03	A	4	产品编号3
BEIY01	A	1	备用字段1位
BEIY04	A	4	备用字段4位
BEIY40	A	40	备用字段40位
BEYINT	N	备用字段int
BEYDEC	P	15	2	备用字段double
CHAXLX	A	1	查询类型
KJIGBZ	A	1	是否需要跨机构查询授权标志
ECLRBZ	A	1	是否需要二次录入授权标志
ZXRQZD	A	6	止息日期检查字段名
JXYFZD	A	6	记息与否检查字段名
SFKHZD	A	6	是否客户查询检查字段名
SRFFZD	A	6	输入方法检查字段名
TCTDZD	A	6	通存通兑检查字段名		
CXJGZD	A	6	被查询机构号检查字段名		
HBDHZD	A	6	货币代号检查字段名		
ZHLXZD	A	6	帐号类型检查字段名
ZHJCZD	A	6	帐号检查字段名
ZHXHZD	A	6	帐号序号检查字段名
BYJC01	A	6	备用1检查字段名
BYJC02	A	6	备用2检查字段名
BYJC03	A	6	备用3检查字段名
BYJC04	A	6	备用4检查字段名
SMSGSR	A	10	Swift进出报标志
SMSGSE	A	6	Swift发送标志
DANWZT	A	1	单位状态
SHYNBZ	A	1	印鉴使用标志
LKEHHO	A	20	老客户号
JIAMBZ	A	1	加密标志
JGWJMY	A	8	结果文件密钥
FLDNAM	A	12	字段英文名
FLDDES	A	40	字段中文说明
FLDIDX	A	12	字段列表索引
FLDVAL	A	40	字段列表值
CHJIZL	A	2	拆借种类
GZZJZL	A	2	业务种类
TUSHZL	A	2	托收种类
ZHJFBZ	A	1	折角分标志
BWTEZH	R	REFFLD(ZHANGH)	表外透支额度帐号
BWTLZH	R	REFFLD(ZHANGH)	表外透支累计帐号
GUSHSJ	R	REFFLD(SHJIAN)	挂失时间
JIGUSJ	R	REFFLD(SHJIAN)	解挂时间
YWULX1	A	1	业务类型
DAE0LX	A	1	大额类型
KAJGTH	A	1	卡的发卡网点机构号替换标志
DENJLX	A	1	登记类型
SMSGML	A	10	Swift报文目录
CNPZZL	A	2	凭证种类
SYHZBZ	A	1	剩余/划转金额标志
YWLEIX	A	1	业务类型
CPZ2XH	R	REFFLD(CPZNXH)	明细文件传票组内序号
KHHDLX	A	1	客户回单类型
SHFBZ1	R	REFFLD(SHFOBZ)	收款行是否浦发行机构
SHKHBM	R	REFFLD(FQHHAO)	收款行代码
SHKHMC	R	REFFLD(HNGMNG)	收款行名称
SKRZHH	R	REFFLD(DUIFZH)	收款人帐号
SKRZWM	R	REFFLD(ZHUZWM)	收款人中文名
SKRYWM	R	REFFLD(YWENMC)	收款人英文名
SHFBZ2	R	REFFLD(SHFOBZ)	付款行是否浦发行机构
FUKHBM	R	REFFLD(FQHHAO)	付款行代码
FUKHMC	R	REFFLD(HNGMNG)	付款行名称
FKRZHH	R	REFFLD(FUKRZH)	付款人帐号
FKRZWM	R	REFFLD(ZHUZWM)	付款人中文名
FKRYWM	R	REFFLD(YWENMC)	付款人英文名
BHSJCY	A	130	本行上级参与者
GNGXQH	A	8	更新期号
REMARK	A	60	备注
JIGOJC	A	20	机构简称
BAWEZT	A	1	来帐报文状态
XDLZZT	A	1	现代支付来帐状态
WHMDBZ	A	1	外汇买跌标志
WHZYBZ	A	1	外汇质押标志
WHJXBZ	A	1	外汇记息标志
YZBZ01	A	1	银证通开通标志-人民币
YZBZ13	A	1	银证通开通标志-港币
YZBZ14	A	1	银证通开通标志-美元
DAYXXA	A	100	打印信息
DAYXXB	A	100	打印信息
DAYXXC	A	100	打印信息
DAYXXD	A	100	打印信息
DAYXXE	A	100	打印信息
DAYXXF	A	100	打印信息
DAYXXG	A	100	打印信息
DAYXXH	A	100	打印信息
DAYXXI	A	100	打印信息
DAYXXJ	A	100	打印信息
DAYXXK	A	100	打印信息
ZHJYBZ	R	REFFLD(JIAOYM)	组合交易标志
HUIZBS	N	汇总笔数
KMHZBS	N	科目汇总笔数
SCJYBW	A	8192	上传交易报文
XCJYBW	A	8192	上传交易报文
TCBZGZ	A	1	头寸补足规则
YUEELX	A	1	余额类型
HANGBS	A	2	他行标识
TIAOXM	A	40	条形码
FENTLX	A	1	分摊类型